Symbol	Description
14D	1414 Degrees Limited
1AD	Adalta Limited
1AE	Aurora Energy Metals Limited
1AG	Alterra Limited
1AI	Algorae Pharmaceuticals Limited
1AIO	1AIO
1CG	One Click Group Limited
1CGO	1CGO
1MC	Morella Corporation Limited
1TT	Thrive Tribe Technologies Limited
29M	29metals Limited
360	Life360 Inc.
360KOA	360KOA
360KOB	360KOB
360KOC	360KOC
360KOD	360KOD
360KOE	360KOE
3DA	Amaero International Ltd
3DAO	3DAO
3DP	Pointerra Limited
3PL	3p Learning Limited..
4DS	4ds Memory Limited
4DX	4dmedical Limited
4DXO	4DXO
5EA	5e Advanced Materials Inc.
5GG	Pentanet Limited
5GN	5g Networks Limited
88E	88 Energy Limited
88EOA	88EOA
8CO	8common Limited
8IH	8i Holdings Ltd
8VI	8vic Holdings Limited
A11	Atlantic Lithium Limited
A1G	African Gold Limited
A1M	Aic Mines Limited
A1N	Arn Media Limited
A200	A200
A2M	The A2 Milk Company Limited
A2MKOB	The A2 Milk Company Limited
A2MKOD	The A2 Milk Company Limited
A2MKOF	The A2 Milk Company Limited
A2MKOP	The A2 Milk Company Limited
A2MKOQ	The A2 Milk Company Limited
A2MKOS	The A2 Milk Company Limited
A2MKOV	A2MKOV
A3D	Aurora Labs Limited
A4N	Alpha Hpa Limited
A8G	Australasian Gold Limited
AAA	Betashares Australian High Interest Cash
AAC	Australian Agricultural Company Ltd
AAI	Alcoa Inc (USA CUFS)
AAJ	Aruma Resources Limited
AAJO	AAJO
AAL	Apac Coal Ltd
AAM	A1 Minerals Ltd
AAP	Australian Agricultural Projects Limited
AAR	Anglo Australian Resources NL
AARO	Astral Resources Nl
AASF	AASF
AAU	Adcorp Australia Ltd
AAUO	AAUO
AAUOC	AAUOC
ABA	Auswide Bank Ltd
ABB	Aussie Broadband Ltd
ABE	Australian Bond Exchange Holdings Limited
ABG	Abigroup
ABV	Advanced Braking Technology Ltd
ABX	Abelle Ltd
ABXO	Abelle
ABY	Adore Beauty Group Ltd
AC8	Auscann Group Holdings Ltd
ACDC	Etfs Battery Tech & Lithium
ACE	Advanced Engine Components Ltd
ACF	Acumen Capital Property Securities Fund
ACL	Alchemia Ltd
ACM	Australian Critical Minerals Limited
ACMOA	ACMOA
ACP	Audalia Resources Limited
ACQ	Acorn Capital Investment Fund Limited
ACR	Acrux Ltd
ACS	Accent Resources NL
ACU	Acuvax Limited
ACW	Actinogen Ltd
AD1	Applydirect Limited
AD8	Audinate Group Limited
ADA	Adacel Technologies Ltd
ADC	Acdc Metals Ltd
ADCO	ADCO
ADD	Adavale Resources Ltd
ADDOA	ADDOA
ADEF	ADEF
ADG	Adtrans Group Ltd
ADGO	ADGO
ADGOA	ADGOA
ADH	Adairs Limited
ADN	Adelaide Resources Ltd
ADO	
ADOO	Anteo Diagnostics Limited
ADR	Adherium Limited
ADS	ADV Group Ltd
ADT	Advent Ltd
ADV	Australian Development Capital Fund
ADX	Audax Resources Ltd
ADXO	ADXO
ADY	Admiralty Resources NL
AEE	Aura Energy Ltd
AEEOC	AEEOC
AEF	Australian Ethical Investments Ltd
AEI	Aeris Technologies Ltd
AER	Aeeris Ltd
AESG	AESG
AEV	Avenira Limited
AEVO	Avenira Limited
AFA	ASF Group Ltd
AFG	Allco Finance Group Ltd
AFI	Australian Foundation Invest Ltd
AFL	Australian Pure Fruits Ltd
AFP	Aft Pharmaceuticals Limited
AGC	Agincourt Resources Ltd
AGD	Austral Gold Ltd
AGE	Alligator Energy Limited
AGEOC	AGEOC
AGH	Australian Growth Properties
AGI	Ainsworth Game Technology Ltd
AGL	AGL Energy Limited
AGLKOA	Agl Energy Limited.
AGLKOB	Agl Energy Limited.
AGLKOC	Agl Energy Limited.
AGLKOP	Agl Energy Limited.
AGLKOQ	Agl Energy Limited.
AGN	Argenica Therapeutics Limited
AGR	Aguia Resources Limited
AGVT	AGVT
AGX1	AGX1
AGY	Argosy Minerals Inc (CUFS)
AHC	AHC Ltd
AHF	Australian Dairy Farms Group
AHI	Allco Hit Ltd
AHK	Ark Mines Limited
AHL	Ahalife Holdings Limited
AHN	Athena Resources Ltd
AHNO	AHNO
AHX	Apiam Animal Health Limited
AI1	Adisyn Ltd
AIA	Auckland International Airport Ltd
AII	ABRA Mining Ltd
AIM	Aim Resources Ltd
AIQ	Alternative Investment Trust
AIS	Automotive Industrial & Mining Supplies
AIV	Activex Ltd
AIZ	Air New Zealand Ltd
AJL	AJ Lucas Group Ltd
AJQ	Armour Energy Limited
AJX	Alexium International Group Limited
AJY	Asaplus Resources Limited
AKG	AKG
AKM	Aspire Mining Limited
AKN	Auking Mining Limited
AKO	Akora Resources Limited
AKP	Audio Pixels Holdings Limited
AL3	Aml3d Limited
AL8	Alderan Resources Limited
AL8OA	Alderan Resources Limited
ALA	Applabs Technologies Ltd
ALB	Albidon Ltd
ALC	Alcidion Group Limited
ALD	Allied Gold Ltd
ALDKOA	ALDKOA
ALDKOB	ALDKOB
ALDKOP	ALDKOP
ALDKOQ	Ampol Limited
ALDKOS	ALDKOS
ALI	Argo Global Listed Infrastructure Limited
ALK	Alkane Exploration Ltd
ALL	Aristocrat Leisure Ltd
ALLKOA	Aristocrat Leisure Limited
ALLKOB	Aristocrat Leisure Limited
ALLKOE	Aristocrat Leisure Limited
ALLKOG	Aristocrat Leisure Limited
ALLKOP	Aristocrat Leisure Limited
ALLKOQ	Aristocrat Leisure Limited
ALLKOT	Aristocrat Leisure Limited
ALLKOU	Aristocrat Leisure Limited
ALM	Australis Media Ltd broke
ALQ	Als Limited
ALQKOA	Als Limited
ALQKOD	Als Limited
ALQKOE	Als Limited
ALQKOF	Als Limited
ALQKOP	Als Limited
ALQKOQ	Als Limited
ALQKOR	Als Limited
ALQKOS	Als Limited
ALR	Aberdeen Leaders Ltd
ALROB	ALROB
ALTB	ALTB
ALU	Altium Ltd
ALUKOA	Altium Limited
ALUKOB	Altium Limited
ALUKOC	Altium Limited
ALUKOD	Altium Limited
ALV	Alvo Minerals Limited
ALX	Allstate Explorations NL
ALXKOA	Atlas Arteria
ALXKOB	Atlas Arteria
ALXKOQ	Atlas Arteria
ALXKOR	Atlas Arteria
ALXKOS	Atlas Arteria
ALY	Alchemy Resources Ltd
AM7	Arcadia Minerals Limited
AMA	Allomak Ltd
AMC	Amcor Ltd
AMCKOC	Amcor Limited
AMCKOG	Amcor Plc
AMCKOP	Amcor Limited
AMCKOS	Amcor Limited
AMD	Arrow Minerals Ltd
AME	Austmet Resources Ltd
AMH	AMCIL Ltd
AMI	Aurelia Metals Limited
AML	AMRAD Corporation Ltd
AMM	Amcom Telecommunications Ltd
AMN	Agrimin Limited
AMO	Ambertech Ltd
AMP	AMP Ltd
AMPKOA	Amp Limited
AMPKOB	Amp Limited
AMPKOC	Amp Limited
AMPKOD	Amp Limited
AMPKOG	Amp Limited
AMPKOR	Amp Limited
AMPKOS	Amp Limited
AMPKOT	Amp Limited
AMPKOV	Amp Limited
AMPLOA	Amp Limited
AMPPB	Amp Limited
AMS	Allied Mining & Processing Nl
AMSO	AMSO
AMT	Advanced Surgical Design & Manufacture Ltd
AMX	Ampella Mining Ltd
AN1	Anagenics Limited
AN3PH	AN3PH
AN3PI	AN3PI
AN3PJ	AN3PJ
AN3PK	AN3PK
AN3PL	AN3PL
AND	Andean Resources Ltd
ANG	Austin Engineering Ltd
ANL	Anaconda Nickel Nl
ANN	Ansell Ltd
ANNKOB	Ansell Limited
ANNKOP	Ansell Limited
ANNKOQ	Ansell Limited
ANO	Advanced Nanotechnology Ltd
ANR	Anatara Lifesciences Ltd
ANX	Anadis Ltd
ANZ	Australia & NZ Banking Group Ltd
ANZKOA	Australia And New Zealand Banking Group Limited
ANZKOB	Australia And New Zealand Banking Group Limited
ANZKOC	Australia And New Zealand Banking Group Limited
ANZKOD	Australia And New Zealand Banking Group Limited
ANZKOE	Australia And New Zealand Banking Group Limited
ANZKOG	Australia And New Zealand Banking Group Limited
ANZKOH	Australia And New Zealand Banking Group Limited
ANZKOI	Australia And New Zealand Banking Group Limited
ANZKOM	Australia And New Zealand Banking Group Limited
ANZKOR	Australia And New Zealand Banking Group Limited
ANZKOS	Australia And New Zealand Banking Group Limited
ANZKOT	Australia And New Zealand Banking Group Limited
ANZKOU	Australia And New Zealand Banking Group Limited
ANZKOV	Australia And New Zealand Banking Group Limited
ANZKOW	Australia And New Zealand Banking Group Limited
ANZMOB	Australia And New Zealand Banking Group Limited
ANZMOU	ANZMOU
AO1	Assetowl Limited
AOA	
AOF	AMP Office Trust
AON	Apollo Minerals Ltd
AOV	Amotiv Limited
AOVKOA	AOVKOA
APA	Australian Pipeline Trust
APAKOA	Apa Group
APAKOE	APAKOE
APAKOQ	Apa Group
APAKOR	Apa Group
APC	Australian Potash Limited
APCO	APCO
APE	AP Eagers Holdings Ltd
APL	Australian Plantation Timber Ltd
APM	Australian Institute of Prop Managmnt
APS	Allup Silica Limited
APW	Aims Property Securities Fund
APX	Appen Limited
APZ	Aspen Group
AQC	Australian Pacific Coal Limited
AQD	AusQuest Ltd
AQI	Alicanto Minerals Limited
AQLT	AQLT
AQN	Aquirian Limited
AQX	Alice Queen Limited
AQXOA	AQXOA
AQXOC	AQXOC
AQZ	Alliance Aviation Services Limited
AR1	Arrowhead Resources Limited
AR3	Australian Rare Earths Limited
AR9	Archtis Limited
ARA	Ariadne Australia Ltd
ARB	Arb Corporation Limited.
ARBKOA	Arb Corporation Limited.
ARBKOB	Arb Corporation Limited.
ARBKOE	ARBKOE
ARBKOR	ARBKOR
ARC	Amalg Resources Nl
ARD	Argent Minerials Lts
ARDO	Argent Minerials Lts
ARF	Arena Reit
ARG	Argo Investments Ltd
ARL	Austrim
ARN	Arnotts Ltd t/over Campbell Soup Co
ARR	Arasor International Ltd
ART	Amp Shopping Centre ord unit
ARU	Arafura Resources NL
ARUOA	ARUOA
ARV	Artemis Resources Ltd
ARVOC	ARVOC
ARX	Austindo Resources Corporation NL
AS1	Angel Seafood Holdings Ltd
AS2	Askari Metals Limited
AS2O	AS2O
ASAO	ASAO
ASB	Austal Ltd
ASE	Astute Metals Nl
ASG	Autosports Group Limited.
ASH	Ashley Services Group Limited
ASIA	Betashares Asia Technology Tigers
ASK	Amskan
ASL	Ausdrill Ltd
ASM	Australian Strategic Materials Limited
ASMO	ASMO
ASN	Anson Resources Limited
ASO	Australian Silicon Ltd
ASP	Aspermont Ltd
ASQ	Asset Loans Ltd
ASR	Australian Rural Group Ltd
ASRO	ASRO
ASV	Argus Solutions Ltd
ASX	Australian Stock Exchange Ltd
ASXKOB	Asx Limited
ASXKOC	Asx Limited
ASXKOD	Asx Limited
ASXKOP	Asx Limited
ASXKOQ	Asx Limited
ASXKOR	Asx Limited
AT1	Atomo Diagnostics Limited
ATA	Atc Alloys Ltd
ATC	Advantage Telecommunications Ltd
ATEC	ATEC
ATG	Austin Group Ltd
ATH	Atech Holdings Ltd
ATHO	ATHO
ATM	Aneka Tambang (Persero) Tbk (Indo)
ATOM	ATOM
ATP	Atlas Pacific Ltd
ATR	Astron Ltd
ATS	Australis Oil & Gas Limited
ATU	Atrum Coal Nl
ATV	Atlantic Gold NL
ATX	Austminex Ltd
AU1	Ausnet Financial Services Limited
AUA	Australian Assets Corporation
AUB	Austbrokers Holdings Ltd
AUC	Ausgold Limited
AUE	Aurum Resources Limited
AUEO	AUEO
AUG	Aurora Gold
AUH	Australian Healthcare Technology Ltd
AUI	Australian United Investment Ltd
AUK	Augur Resources Ltd
AUKOA	Aumake Limited.
AUMF	Ishares Edge Msci Australia Multifactor Etf
AUN	Austar United Communications Ltd
AUNO	Aurumin Limited
AUNOC	AUNOC
AUQ	Alara Uranium Ltd
AUR	Auris Minerals Limited
AUST	Betashares Managed Risk Australian Share Fund (man
AUZ	Australian Mines Ltd
AUZOA	AUZOA
AUZOB	AUZOB
AV1	Adveritas Limited
AVA	Aviva Corporation Ltd
AVC	Australian Visual Communications
AVD	Advance Energy Ltd
AVE	Aevum Ltd
AVEOA	AVEOA
AVG	Australian Vintage Ltd t/over by SWS
AVH	Avita Medical Ltd
AVJ	AV Jennings Homes Ltd
AVL	Anvil Mining Nl
AVM	Anvil Mining Ltd (Canada CUFS)
AVMO	AVMO
AVR	Avatar Industries Ltd
AVW	Avira Energy Limited
AVWOA	Avira Resources Ltd
AW1	American West Metals Limited
AW1O	American West Metals Limited
AWC	Alumina Ltd
AWCKOA	Alumina Limited
AWCKOB	Alumina Limited
AWCKOC	Alumina Limited
AWCKOD	Alumina Limited
AWCKOP	Alumina Limited
AWCKOR	Alumina Limited
AWCKOT	Alumina Limited
AWCKOU	Alumina Limited
AWCKOX	Alumina Limited
AWJ	Auric Mining Limited
AX1	Accent Group Limited
AX8	Accelerate Resources Limited
AXE	Archer Exploration Ltd
AXI	Axiom Properties Ltd
AXL	Aucxis
AXN	Axon Instruments Inc
AXP	Airxpanders Inc
AYA	Attila Resources Limited
AYI	A1 Investments & Resources Ltd
AYM	Altius Mining Limited
AYT	Adelaide Managed Funds Asset Trust
AYUHC	Australian Unity Limited
AYUHD	Australian Unity Limited
AYUHE	AYUHE
AYUPA	AYUPA
AZ9	Asian Battery Metals Plc
AZ9O	AZ9O
AZI	Alta Zinc Limited
AZJ	Aurizon Holdings Limited
AZJKOA	Aurizon Holdings Limited
AZJKOB	Aurizon Holdings Limited
AZJKOC	Aurizon Holdings Limited
AZJKOD	Aurizon Holdings Limited
AZJKOQ	Aurizon Holdings Limited
AZJKOS	Aurizon Holdings Limited
AZJKOT	Aurizon Holdings Limited
AZL	Anzoil Nl
AZLO	AZLO
AZLOA	Arizona Lithium Limited
AZY	Antipa Minerals Limited
B4P	Beforepay Group Limited
BANK	BANK
BAOR	BAOR
BAP	Burson Group Limited
BAPKOA	Bapcor Limited
BAPKOB	Bapcor Limited
BAPKOR	Bapcor Limited
BAS	Bass Strait Oil Company Ltd
BASO	Bass Strait Oil Company Limited
BB1	Blinklab Limited
BBAB	BBAB
BBC	Babcock & Brown Communities Group
BBL	Brisbane Broncos Ltd
BBN	Baby Bunting Group Limited
BBOZ	Betashares Australian Equities Strong Bear Hedge F
BBT	Bluebet Holdings Ltd
BC8	Black Cat Syndicate Limited
BC8O	BC8O
BCA	Baycorp Advantage Ltd
BCB	Bowen Coking Coal Limited
BCC	Buccaneer Energy Ltd
BCI	BC Iron Ltd
BCK	Brockman Mining Limited
BCM	Babcock & Brown Capital Ltd
BCMO	BCMO
BCMOA	BCMOA
BCN	Beacon Minerals Ltd
BCOM	BCOM
BCT	Bluechiip Limited
BDG	Bendigo Mining Ltd
BDM	Biodiem Ltd
BDT	Birddog Technology Limited
BDX	Bcal Diagnostics Limited
BEAR	Betashares Australian Equities Bear Hedge Fund
BEL	Bentley International Ltd
BEN	Bendigo Bank Ltd
BENKOB	Bendigo And Adelaide Bank Limited
BENKOC	Bendigo And Adelaide Bank Limited
BENKOD	Bendigo And Adelaide Bank Limited
BENKOP	Bendigo And Adelaide Bank Limited
BENKOQ	Bendigo And Adelaide Bank Limited
BENKOT	Bendigo And Adelaide Bank Limited
BENPH	BENPH
BENPI	BENPI
BEO	Beonic Ltd
BET	Belmont Holdings Ltd
BEZ	Besra Gold Inc
BFC	Beston Global Food Company Limited
BFG	Bell Financial Group Ltd
BFL	Bsp Financial Group Limited
BGA	Bega Cheese Limited
BGBL	BGBL
BGD	Boulder Steel Ltd
BGE	Bridge Saas Limited
BGL	Bigair Group Ltd
BGLKOB	BGLKOB
BGLKOC	BGLKOC
BGLKOD	BGLKOD
BGLKOR	BGLKOR
BGP	Briscoe Group Australasia Limited
BGT	Bio-gene Technology Ltd
BHD	Benjamin Hornigold Limited
BHP	BHP Billiton Ltd
BHPKOA	Bhp Billiton Limited
BHPKOB	Bhp Billiton Limited
BHPKOC	Bhp Billiton Limited
BHPKOD	Bhp Billiton Limited
BHPKOE	Bhp Billiton Limited
BHPKOF	Bhp Billiton Limited
BHPKOG	Bhp Billiton Limited
BHPKOH	Bhp Billiton Limited
BHPKOI	Bhp Billiton Limited
BHPKOK	Bhp Billiton Limited
BHPKOO	Bhp Billiton Limited
BHPKOP	Bhp Billiton Limited
BHPKOQ	Bhp Billiton Limited
BHPKOR	Bhp Billiton Limited
BHPKOW	Bhp Billiton Limited
BHPKOY	Bhp Billiton Limited
BHPMOP	Bhp Billiton Limited
BHPMOR	Bhp Billiton Limited
BHYB	BHYB
BILL	Ishares Core Cash
BIM	Bindi Metals Limited
BIO	Biome Australia Limited
BIS	
BIT	Biotron Ltd
BITOC	BITOC
BKG	Buka Gold Ltd
BKI	Brickworks Investment Company Ltd
BKT	Black Rock Mining Limited
BKW	Brickworks Ltd
BKWKOB	Brickworks Limited
BKWKOD	BKWKOD
BKY	Berkeley Resources Ltd
BLG	Blugass Ltd
BLGO	Bluglass Limited
BLU	Bluefreeway Ltd
BLX	Beacon Lighting Group Limited
BLZ	Blaze International Ltd
BM8	Battery Age Minerals Ltd
BMG	Brazilian Metals Group Limited.
BMH	Baumart Holdings Limited
BML	Bank of Melbourne merger WBC
BMM	Bellamel Mining Ltd
BMN	Bannerman Resources Ltd
BMO	BMA Gold Ltd
BMOOA	BMOOA
BMR	Balmoral Corporation
BMT	Berkut Minerals Limited
BNL	Balkans Gold Ltd
BNR	Bulletin Resources Limited
BNRO	BNRO
BNZ	Benz Mining Corp.
BOA	Boadicea Resources Limited
BOAO	Boadicea Resources Limited
BOC	Bougainville Copper Ltd (PNG)
BOD	bioMD Ltd
BOE	Boss Energy Ltd
BOEKOA	BOEKOA
BOEKOC	BOEKOC
BOL	Boom Logistics Ltd
BOQ	Bank of Queensland Ltd
BOQKOA	Bank Of Queensland Limited.
BOQKOD	Bank Of Queensland Limited.
BOQKOE	Bank Of Queensland Limited.
BOQKOF	Bank Of Queensland Limited.
BOQKOR	Bank Of Queensland Limited.
BOQKOS	Bank Of Queensland Limited.
BOQPE	Bank Of Queensland Limited.
BOQPF	BOQPF
BOQPG	BOQPG
BOT	Botanix Pharmaceuticals Ltd
BP8	Bph Global Ltd
BPH	BioPharmica Ltd
BPHOB	BPHOB
BPM	Bpm Minerals Limited
BPMO	BPMO
BPP	Babylon Pump & Power Limited
BPT	Beach Petroleum Ltd
BPTKOA	Beach Energy Limited
BPTKOB	Beach Energy Limited
BPTKOD	Beach Energy Limited
BPTKOP	Beach Energy Limited
BPTKOR	Beach Energy Limited
BRE	Breathe Group
BRG	Breville Group Ltd
BRGKOA	Breville Group Limited
BRGKOB	Breville Group Limited
BRI	Breakwater Island Trust
BRK	BreakFree Ltd
BRL	Brl Hardy
BRN	Brainchip Holdings Ltd
BRU	Buru Energy Ltd
BRX	Belararox Limited
BRXOA	BRXOA
BSA	Broadcast Services Australia Ltd
BSAO	Bsa Limited
BSE	BSE
BSL	BlueScope Steel Ltd
BSLKOC	Bluescope Steel Limited
BSLKOE	Bluescope Steel Limited
BSLKOP	Bluescope Steel Limited
BSLKOT	Bluescope Steel Limited
BSLKOU	Bluescope Steel Limited
BSN	Bisan Ltd
BSUB	BSUB
BSX	Blackstone Minerals Limited
BTC	BioTech Capital Ltd
BTE	BT Australian Equity Management
BTH	Bigtincan Holdings Limited
BTI	Bailador Technology Investments Limited
BTN	Brighton Mining Group Limited
BTR	Blackthorn Resources Ltd
BUB	Bubs Australia Limited
BUGG	BUGG
BUR	Burleson Energy Ltd
BUS	Bubalus Resources Limited
BUX	Buxton Resources Ltd
BUXO	Buxton Resources Limited
BUY	Bounty Oil & Gas NL
BVR	Bellavista Resources Ltd
BVS	Bravura Solutions Limited.
BWF	Blackwall Property Funds Limited
BWN	Bowen Energy Ltd
BWP	Bunnings Warehouse Property Trust
BXB	Brambles Ltd
BXBKOA	Brambles Limited
BXBKOB	Brambles Limited
BXBKOD	Brambles Limited
BXBKOP	Brambles Limited
BXBKOS	Brambles Limited
BXN	Bioxyne Limited
BYE	Byron Energy Limited
BYH	Bryah Resources Limited
BYHO	Bryah Resources Limited
C1X	Cosmos Exploration Limited
C29	C29 Metals Limited
C2FHA	C2FHA
C79	Chrysos Corporation Limited
C7A	Clara Resources Australia Ltd
CAA	Capral Aluminium Ltd
CAE	Cannindah Resources Limited
CAF	Centrepoint Alliance Ltd
CAG	Cape Range Wireless Ltd
CAI	Casinos Austria International
CAIO	Calidus Resources Limited
CAIOA	CAIOA
CAJ	Capitol Health Ltd
CAM	Clime Capital Ltd
CAMG	Clime Capital Limited
CAN	Cann Group Limited
CAQ	Cell Aquaculture Ltd
CAR	Carsales.com Limited.
CARKOA	Carsales.com Limited.
CARKOB	Carsales.com Limited.
CARKOF	Carsales.com Limited.
CAT	Catuity Inc (USA)
CAV	Carnavale Resources Ltd
CAY	Canyon Resources Ltd
CAZ	Cazaly Resources Ltd
CBA	Commonwealth Bank Ltd
CBAKOA	Commonwealth Bank Of Australia.
CBAKOC	Commonwealth Bank Of Australia.
CBAKOD	Commonwealth Bank Of Australia.
CBAKOE	Commonwealth Bank Of Australia.
CBAKOF	Commonwealth Bank Of Australia.
CBAKOG	Commonwealth Bank Of Australia.
CBAKOH	Commonwealth Bank Of Australia.
CBAKOI	Commonwealth Bank Of Australia.
CBAKOP	Commonwealth Bank Of Australia.
CBAKOQ	Commonwealth Bank Of Australia.
CBAKOS	Commonwealth Bank Of Australia.
CBAKOT	Commonwealth Bank Of Australia.
CBAKOX	Commonwealth Bank Of Australia.
CBAKOY	Commonwealth Bank Of Australia.
CBAMOA	Commonwealth Bank Of Australia.
CBAMOB	Commonwealth Bank Of Australia.
CBAMOP	Commonwealth Bank Of Australia.
CBAMOQ	Commonwealth Bank Of Australia.
CBAPG	Commonwealth Bank Of Australia.
CBAPI	Commonwealth Bank Of Australia.
CBAPJ	CBAPJ
CBAPK	CBAPK
CBAPL	CBAPL
CBAPM	CBAPM
CBE	Cobre Limited
CBH	CBH Resources Ltd
CBHO	CBHO
CBHOA	CBHOA
CBL	Cbl Corporation Limited
CBO	Cobra Resources Nl
CBY	Canterbury Resources Limited
CC9	Chariot Corporation Ltd
CCA	Chimpchange Limited
CCE	Clinical Cell Culture Ltd
CCG	Commschoice Group Limited
CCM	Cadoux Limited
CCO	CircleCom Ltd
CCOOA	CCOOA
CCP	Credit Corp Group Ltd
CCPKOA	Credit Corp Group Limited
CCPKOB	Credit Corp Group Limited
CCPKOC	Credit Corp Group Limited
CCPKOD	Credit Corp Group Limited
CCR	Credit Clear Limited
CCV	Cash Converters International Ltd
CCX	City Chic Collective Limited
CCZ	Castillo Copper Limited
CCZOA	CCZOA
CD1	Cordish Dixon Private Equity Fund I
CD2	Cordish Dixon Private Equity Fund Ii
CD3	Cordish Dixon Private Equity Fund Iii
CDA	Codan Ltd
CDD	Cardno Ltd
CDE	Codeifai Limited
CDM	Cadence Capital Ltd
CDO	Colorado Group Ltd
CDP	Carindale Property Trust
CDR	Commander Communications Ltd
CDRO	Codrus Minerals Limited
CDT	Castle Minerals Ltd
CDTOA	CDTOA
CDTOB	CDTOB
CDX	CDS Technologies Ltd
CDXOA	CDXOA
CE1	Calima Energy Limited
CEH	China Education Ltd
CEL	CEL
CEN	Central Australian Phosphate Limited
CETF	Vaneck Vectors Chinaamc A-share?
CF1	Complii Fintech Solutions Ltd
CFLO	CFLO
CFO	Cfoam Limited
CG1	Carbonxt Group Limited
CGF	Challenger Financial Services Group
CGFKOB	Challenger Limited
CGFKOC	Challenger Limited
CGFKOE	Challenger Limited
CGFKOP	Challenger Limited
CGFKOR	Challenger Limited
CGFKOS	Challenger Limited
CGFPC	CGFPC
CGFPD	CGFPD
CGO	CPT Global Ltd
CGR	Careers Multilist Limited
CGS	Cogstate Ltd
CGUN	CGUN
CHC	Charter Hall Group
CHCKOA	Charter Hall Group
CHCKOC	Charter Hall Group
CHCKOD	Charter Hall Group
CHCKOQ	Charter Hall Group
CHCKOS	CHCKOS
CHCKOT	Charter Hall Group
CHL	CCI Holdings Ltd
CHM	Chameleon Mining NL
CHN	Chalice Gold Mines Ltd
CHNKOA	CHNKOA
CHNKOP	CHNKOP
CHR	Chalmers Ltd
CHW	Chilwa Minerals Ltd
CI1	Credit Intelligence Ltd
CIA	Champion Iron Limited
CIAKOA	CIAKOA
CIAKOB	CIAKOB
CIAKOC	CIAKOC
CIAKOD	CIAKOD
CIAKOP	CIAKOP
CIAKOQ	CIAKOQ
CIN	Carlton Investments Ltd
CINPA	Carlton Investments PA
CIO	Connected Io Limited
CIP	Centuria Industrial Reit
CIW	Clime Investment Management Ltd
CKA	Cokal Limited
CKF	Collins Foods Limited
CKFKOA	Collins Foods Limited
CKFKOB	CKFKOB
CKFKOC	CKFKOC
CL8	Collaborate Corporation Limited
CL8O	Collaborate Corporation Limited
CLA	Celsius Coal Limited
CLE	Clearwater Group Ltd
CLG	Close The Loop Ltd.
CLU	Cloncurry Metals Ltd
CLV	Clover Corporation Ltd
CLW	Charter Hall Long Wale Reit
CLX	CTI Logistics Ltd
CLZ	Classic Minerals Ltd
CMB	Cambium Bio Limited
CMD	Cassius Mining Limited
CMG	Commonwealth Installment Receipts Trst
CMM	Capricorn Metals Ltd
CMMKOA	Capricorn Metals Ltd
CMMKOD	CMMKOD
CMO	CommodiTel Ltd
CMOO	CMOO
CMP	Compumedics Ltd
CMW	Cromwell Corporation Ltd
CMX	Climax Mining Ltd
CMXO	Chemx Materials Limited
CNB	Canberra Investment Corporation Ltd
CND	Candle Australia Ltd
CNDOA	CNDOA
CNI	Centuria Capital Limited
CNJ	Conico Ltd
CNJO	Conico Ltd
CNQ	Carbine Tungsten Limited
CNQO	CNQO
CNU	Chorus Limited
COB	Cobalt Blue Holdings Limited
COD	Cossack Energy Limited
COE	Cooper Energy Ltd
COF	Coffey International Ltd
COG	Consolidated Operations Group Limited
COH	Cochlear Ltd
COHKOA	Cochlear Limited
COHKOB	Cochlear Limited
COHKOC	Cochlear Limited
COHKOD	Cochlear Limited
COHKOG	Cochlear Limited
COHKOQ	Cochlear Limited
COHKOR	Cochlear Limited
COHKOS	Cochlear Limited
COI	Comet Ridge Ltd
COL	Coles Group Limited.
COLKOB	Coles Group Limited.
COLKOC	Coles Group Limited.
COLKOD	Coles Group Limited.
COLKOE	COLKOE
COLKOF	COLKOF
COS	Cool or Cosy Ltd
COV	Cove Mining NL
COY	Coppermoly Ltd
CPM	Cooper Metals Limited
CPMO	CPMO
CPN	Carpathian Resources Ltd
CPO	Culpeo Minerals Limited
CPOO	CPOO
CPU	Computershare Ltd
CPUKOB	Computershare Limited.
CPUKOC	Computershare Limited.
CPUKOE	Computershare Limited.
CPUKOF	Computershare Limited.
CPUKOP	Computershare Limited.
CPUKOR	Computershare Limited.
CPUKOT	Computershare Limited.
CPV	Clearvue Technologies Limited
CQE	Charter Hall Education Trust
CQEKOA	CQEKOA
CQEKOC	CQEKOC
CQR	Charter Hall Retail Reit
CR1	Constellation Resources Limited
CR9	Corella Resources Ltd
CR9O	CR9O
CRB	Carbine Resources Ltd
CRD	Crown Diamonds NL
CRN	Coronado Global Resources Inc.
CRR	Convenience Retail Reit
CRS	Croesus Mining NL
CRYP	CRYP
CSC	Capstone Copper Corp.
CSE	Copper Strike Ltd
CSF	Centro Shopping American Trust
CSFO	CSFO
CSL	CSL Ltd
CSLKOA	Csl Limited
CSLKOB	Csl Limited
CSLKOC	Csl Limited
CSLKOG	Csl Limited
CSLKOH	Csl Limited
CSLKOI	Csl Limited
CSLKOQ	Csl Limited
CSLKOS	Csl Limited
CSLKOT	Csl Limited
CSLKOV	Csl Limited
CSLMOT	Csl Limited
CSR	CSR Ltd
CSS	Clean Seas Tuna Ltd
CST	Cellestis Ltd
CSX	Cleanspace Holdings Limited
CT1	Ccp Technologies Limited
CTD	Corporate Travel Management Limited
CTDKOB	Corporate Travel Management Limited
CTDKOQ	Corporate Travel Management Limited
CTE	Cryosite Ltd
CTM	Centaurus Metals Limited
CTN	Contango Microcap Ltd
CTO	Citigold Corporation Ltd
CTP	Central Petroleum Ltd
CTQ	Careteq Limited
CTT	Crest Minerals Limited
CU6	Clarity Pharmaceuticals Ltd
CUE	Cue Energy Resources Ltd
CUF	Cufe Ltd
CUFO	CUFO
CUL	Cullen Resources Ltd
CUP	Countplus Limited
CUS	Customers Ltd
CUV	Clinuvel Pharmaceuticals Ltd
CVB	Cheviot Bridge Ltd
CVC	CVC Ltd
CVCHA	CVCHA
CVL	Clearview Capital
CVN	Carnarvon Petroleum Ltd
CVR	Central Asia Resources Ltd
CVV	Caravel Minerals Limited
CVVOB	CVVOB
CVW	Clearview Wealth Limited
CWP	Cedar Woods Properties Ltd
CWX	Carawine Resources Limited
CWY	Cleanaway Waste Management Limited
CWYKOC	Cleanaway Waste Management Limited
CWYKOF	Cleanaway Waste Management Limited
CWYKOP	Cleanaway Waste Management Limited
CWYKOQ	Cleanaway Waste Management Limited
CXL	Central Exchange Ltd
CXM	Centrex Mentals Ltd
CXO	Core Exploration Limited
CXU	
CXUO	Cauldron Energy Limited
CXZ	Connexion Media Limited
CY5	Cygnus Gold Limited
CYC	Cyclopharm Ltd
CYG	Coventry Group Ltd
CYL	Catalyst Metals Ltd
CYM	Cyprium Metals Limited
CYP	Cynata Therapeutics Limited
CYPOA	CYPOA
CYQ	Cycliq Group Ltd
CZN	Corazon Mining Limited
CZR	Coziron Resources Ltd
D2O	Duxton Water Limited
D2OOA	D2OOA
D3E	D3 Energy Limited
DAF	Discovery Africa Limited
DAL	Dalaroo Metals Ltd
DAOR	DAOR
DBBF	DBBF
DBF	Duxton Broadacre Farms Limited
DBI	Dalrymple Bay Infrastructure Limited
DBO	Diablo Resources Limited
DCC	Digital Cc Limited
DCG	Decmil Group Limited
DCGPA	DCGPA
DCL	Data & Commerce
DDB	Dynamic Drill And Blast Holdings Limited
DDR	Dicker Data Limited
DDT	DataDot Technology Ltd
DEG	De Grey Mining Ltd
DEL	Delorean Corporation Limited
DEM	De.mem Limited
DES	Destra Corporation Ltd
DESO	DESO
DEV	Devex Resources Limited
DFGH	DFGH
DGGF	DGGF
DGH	Desane Group Holdings Ltd
DGL	Dgl Group Limited
DGR	D'Aguilar Gold Ltd
DHG	Domain Holdings Australia Limited.
DHHF	DHHF
DHOF	DHOF
DJW	Djerriwarth Investments Ltd
DJXKOC	DJXKOC
DJXKOE	DJXKOE
DJXKOJ	DJXKOJ
DJXKOK	DJXKOK
DJXKOM	DJXKOM
DJXKOQ	Djia Mini E-cbot
DJXKOR	Djia Mini E-cbot
DJXKOV	DJXKOV
DJXKOW	DJXKOW
DJXKOY	DJXKOY
DKM	Duketon Mining Limited
DLI	Delta Lithium Limited
DLM	Dominion Minerals Limited
DM1	Directmoney Limited
DM1O	DM1O
DMC	Digimatic Group Limited
DME	Dome Gold Mines Limited
DMG	Dragon Gold Mountain Ltd
DMM	DMC Mining Ltd
DMMO	DMC Mining Ltd
DMP	Domino's Pizza Australia NZ Ltd
DMPKOA	Dominos Pizza Enterprises Limited
DMPKOC	Dominos Pizza Enterprises Limited
DMPKOD	Dominos Pizza Enterprises Limited
DMPKOG	Dominos Pizza Enterprises Limited
DMPKOS	Dominos Pizza Enterprises Limited
DMPKOZ	DMPKOZ
DNA	Donaco International Limited
DNK	Danakali Limited
DOC	Doctor Care Anywhere Group Plc
DOU	Douugh Limited
DOUO	DOUO
DOW	Downer EDI Ltd
DOWKOC	Downer Edi Limited
DOWKOP	Downer Edi Limited
DOWKOR	Downer Edi Limited
DOWKOS	Downer Edi Limited
DOWKOT	Downer Edi Limited
DRA	Dragon Mining NL
DRE	Dalrymple Resources Nl
DRO	Droneshield Limited
DRR	Deterra Royalties Limited
DRRKOA	DRRKOA
DRRKOB	DRRKOB
DRRKOC	DRRKOC
DRUG	Betashares Global Healthcare Etf - Currency Hedged
DRX	Diatreme Resources Ltd
DSE	Dropsuite Limited
DSK	Dusk Group Limited
DTI	Dti Group Ltd
DTL	Data#3 Ltd
DTM	Dart Mining NL
DTR	Dateline Resources Limited
DTRO	DTRO
DTRR	Dateline Resources Limited
DTZ	Dotz Nano Limited
DUB	Dubber Corporation Limited
DUG	Dug Technology Ltd
DUI	Diversified United Investment Ltd
DUN	Dundas Minerals Limited
DUR	Duratec Limited
DVL	Dorsavi Ltd
DVP	Develop Global Limited
DXB	Dimerix Limited
DXBO	DXBO
DXC	Dexus Convenience Retail Reit
DXI	Dexus Industria Reit.
DXN	The Data Exchange Network Limited
DXS	Dexus Property Group
DXSKOA	Dexus Property Group
DXSKOB	Dexus Property Group
DXSKOE	DXSKOE
DXSKOQ	Dexus Property Group
DXSKOR	Dexus Property Group
DY6	Dy6 Metals Ltd
DYL	Deep Yellow Ltd
DYLKOA	DYLKOA
DYLKOB	DYLKOB
DYLKOC	DYLKOC
DYM	Dynamic Metals Limited
DZZF	DZZF
E200	E200
E25	Element 25 Limited
E33	East 33 Limited..
E79	E79 Gold Mines Limited
EAFZ	EAFZ
EAX	Energy Action Limited
EBG	Eumundi Group Ltd
EBO	Ebos Group Limited
EBR	Eagle Bay Resources NL
ECF	Elanor Commercial Property Fund
ECG	Ecargo Holdings Limited
ECH	Echelon Resources Ltd
ECL	Excelsior Capital Ltd
ECP	E Corp
ECPGA	ECPGA
ECS	ECSI Ltd
ECT	Environmental Clean Technologies Limited.
EDC	Eildon Capital Limited
EDE	Eden Energy Ltd
EDEO	Eden Energy Ltd
EDEOC	Eden Innovations Ltd
EDEOD	EDEOD
EDOC	EDOC
EDU	Edu Holdings Limited
EDV	Endeavour Group Limited
EDVKOB	EDVKOB
EDVKOC	EDVKOC
EDVKOD	EDVKOD
EE1	Earths Energy Limited
EEG	Empire Energy Group Limited
EEL	Envirostar Energy
EFE	Eastern Iron Ltd
EG1	Evergreen Lithium Limited
EGG	Enero Group Limited
EGH	Eureka Group Holdings Limited
EGL	Environmental Group Ltd (The)
EGN	EGN
EGR	Ecograf Limited
EGY	Energy Technologies Limited
EGYO	EGYO
EHL	Emeco Holdings Ltd
EIGA	EIGA
EINC	EINC
EIQ	Echoiq Limited
EL8	Elevate Uranium Ltd
ELD	ELD
ELDKOA	Elders Limited
ELDKOB	ELDKOB
ELE	Elmore Ltd
ELS	Equity Long / Short Strategies Fund (the)
ELT	Elementos Limited
EM2	Eagle Mountain Mining Limited
EM2O	EM2O
EMB	Embelton Ltd
EMC	Emefcy Group Limited
EMD	Emerald Clinics Limited
EME	Energy Metals Ltd
EMH	European Metals Holdings Limited
EMKT	Vaneck Vectors Msci Multifactor Emerging Markets E
EML	Emerchants Limited
EMMG	EMMG
EMN	Euro Manganese Inc
EMP	Emperor Mines Ltd
EMPO	EMPO
EMR	Emerald Oil & Gas NL
EMS	Eastland Medical Systems Ltd
EMT	Emetals Limited
EMTO	Emetals Limited
EMU	EMU Nickel NL
EMV	Emvision Medical Devices Limited
EMXC	EMXC
ENL	Eagle Nickel Ltd
ENN	Elanor Investors Group
ENR	Encounter Resources Ltd
ENT	
ENV	Envestra Ltd
ENVO	ENVO
ENX	Enegex Nl
EOF	Ecofibre Limited
EOL	Energy One Ltd
EOS	Electro Optic Systems Holdings Ltd
EP1	E&p Financial Group Limited
EPM	Eclipse Metals Limited.
EPMOA	Eclipse Metals Limited.
EPN	Epsilon Healthcare Limited
EPY	E-Pay Asia Ltd
EQE	Equus Mining Limited
EQN	Equinox Minerals Ltd (Canada CHESS)
EQR	Equinox Resources Nl
EQS	Equs
EQT	Equity Trustees Ltd
EQX	Eqitx Ltd
ERA	Energy Resources of Australia Ltd
ERD	Exalt Resources Limited
ERG	ERG Ltd
ERL	Empire Resources Ltd
ERM	Emmerson Resources Ltd
ERTH	ERTH
ERW	Errawarra Resources Ltd
ESK	Etherstack Plc
ESPO	ESPO
ESR	Estrella Resources Limited
ESROB	ESROB
ETM	Energy Transition Minerals Ltd
ETPMAG	Etfs Physical Silver
ETPMPD	Etfs Physical Palladium
ETPMPM	Etfs Physical Pm Basket
ETPMPT	Etfs Physical Platinum
ETR	ETRADE Australia Ltd
ETRO	ETRO
EUR	Euraust Ltd
EURO	EURO
EUROB	European Lithium Limited
EV1	Evolution Energy Minerals Limited
EVE	Energy Ventures Ltd
EVG	Envirogold Ltd
EVN	Evolution Mining Limited
EVNKOA	Evolution Mining Limited
EVNKOB	Evolution Mining Limited
EVNKOC	Evolution Mining Limited
EVNKOD	Evolution Mining Limited
EVNKOP	Evolution Mining Limited
EVNKOR	Evolution Mining Limited
EVO	Evolve Education Group Limited
EVR	Endeavour Mining Corporation
EVRO	EVRO
EVROA	EVROA
EVS	Envirosuite Limited
EVT	Event Hospitality And Entertainment Ltd
EVZ	Envirozel Ltd
EWC	Energy World Corporation Ltd
EX20	Betashares Australian Ex-20 Portfolio Diversifier
EXL	Excel Coal Ltd
EXLO	EXLO
EXP	Experience Co Limited
EXR	Elixir Petroleum Ltd
EXROB	EXROB
EXT	Extract Resources Ltd
EXTOD	EXTOD
EYE	Eagle Eye Metals Ltd
EZL	Euroz Ltd
EZZ	Ezz Life Science Holdings Limited
F100	F100
FAIR	Betashares Australian Sustainability Leaders
FAL	Falcon Metals Ltd
FANG	FANG
FAR	First Australian Resources Ltd
FATP	FATP
FAU	First Au Limited
FAUO	First Au Limited
FBM	Future Battery Minerals Limited
FBR	Fastbrick Robotics Ltd
FBU	Fletcher Building Ltd
FBUKOA	Fletcher Building Limited
FBUKOP	Fletcher Building Limited
FBUKOS	Fletcher Building Limited
FCAP	FCAP
FCG	Frontier Capital Group Limited
FCL	Futuris Corporation Ltd
FCT	Firstwave Cloud Technology Limited
FDR	Federation Group Ltd
FDV	Frontier Digital Ventures Limited
FEG	Far East Gold Ltd
FEX	Fenix Resources Ltd
FFF	First Folio Ltd
FFG	Fatfish Internet Group Ltd
FFGO	Fatfish Internet Group Ltd
FFI	FFI Holdings Ltd
FFM	Firefly Metals Ltd
FG1	Flynn Gold Limited
FG1O	FG1O
FGG	Future Generation Global Investment Company Limited
FGH	Foresta Group Holdings Limited
FGL	Foster's Group Ltd
FGR	First Graphite Limited
FGX	Future Generation Investment Fund Limited
FHCO	FHCO
FHE	Frontier Energy Limited
FHNG	FHNG
FHS	Freehill Mining Limited.
FID	Fiducian Group Limited
FIIN	FIIN
FIN	Aii S&p/asx 200 Financials
FL1	First Lithium Limited
FL1O	FL1O
FLC	Fluence Corporation Limited
FLN	Freelancer Limited
FLOT	Vaneck Vectors Australian Floating Rate
FLT	Flight Centre Ltd
FLTKOA	Flight Centre Travel Group Limited
FLTKOB	Flight Centre Travel Group Limited
FLTKOC	Flight Centre Travel Group Limited
FLTKOD	Flight Centre Travel Group Limited
FLTKOQ	Flight Centre Travel Group Limited
FLTKOR	Flight Centre Travel Group Limited
FLX	Felix Resources Ltd
FME	Future Metals Nl
FMG	Fortescue Metals Group Ltd
FMGKOC	Fortescue Metals Group Ltd
FMGKOG	Fortescue Metals Group Ltd
FMGKOH	Fortescue Metals Group Ltd
FMGKOL	Fortescue Metals Group Ltd
FMGKOP	Fortescue Metals Group Ltd
FMGKOS	Fortescue Metals Group Ltd
FMGKOT	Fortescue Metals Group Ltd
FMGKOU	Fortescue Metals Group Ltd
FMGKOZ	Fortescue Metals Group Ltd
FMGMOP	Fortescue Metals Group Ltd
FML	Focus Minerals Ltd
FMR	Fmr Resources Limited
FND	Finders Resources Ltd
FNR	Far Northern Resources Limited
FNX	Finexia Financial Group Limited
FOS	Fos Capital Ltd
FPC	Fat Prophets Global Contrarian Fund Ltd
FPH	Fisher & Paykel Healthcare Corp Ltd
FPHKOA	FPHKOA
FPHKOD	FPHKOD
FPHKOE	Fisher & Paykel Healthcare Corporation Limited
FPP	Fat Prophets Global Property Fund
FPR	Fleetpartners Group Limited
FRAR	FRAR
FRB	Firebird Metals Limited
FRE	Freshtel Holdings Ltd
FRGG	FRGG
FRI	Finbar International Ltd
FRM	Farm Pride Foods Ltd
FRS	Ferraus Ltd
FRSO	Forrestania Resources Limited
FRSOA	FRSOA
FRSOB	FRSOB
FRW	Freightways Group Limited
FRX	Flexiroam Limited
FSA	FSA Group Ltd
FSF	Fonterra Shareholders Fund
FSG	Field Solutions Holdings Limited
FSI	Flagship Investments Limited
FSIGA	FSIGA
FTC	Fintech Chain Limited
FTL	Firetail Resources Limited
FTZ	Fertoz Limited
FUEL	Betashares Global Energy Companies - Currency Hedg
FUTR	FUTR
FWD	Fleetwood Corporation Ltd
FXEKOB	Currency Warrant Aud/eur
FXEKOC	FXEKOC
FXEKOR	FXEKOR
FXEKOS	Currency Warrant Aud/eur
FXEKOT	FXEKOT
FXEKOV	FXEKOV
FXG	Felix Gold Limited
FXGO	FXGO
FXPKOB	FXPKOB
FXPKOC	FXPKOC
FXPKOD	FXPKOD
FXPKOE	FXPKOE
FXPKOF	FXPKOF
FXPKOG	FXPKOG
FXPKOQ	Currency Warrant Aud/gbp
FXPKOR	FXPKOR
FXPKOS	FXPKOS
FXPKOT	FXPKOT
FXPKOV	FXPKOV
FXUKOC	Currency Warrant Aus/usd.
FXUKOJ	FXUKOJ
FXUKOK	FXUKOK
FXUKOL	FXUKOL
FXUKOM	FXUKOM
FXUKOQ	Currency Warrant Aus/usd.
FXUKOR	Currency Warrant Aus/usd.
FXUKOS	Currency Warrant Aus/usd.
FXUKOV	Currency Warrant Aus/usd.
FXUKOW	Currency Warrant Aus/usd.
FXUKOY	Currency Warrant Aus/usd.
FXUKOZ	Currency Warrant Aus/usd.
FXUMOE	FXUMOE
FXUMOP	FXUMOP
FXUMOQ	FXUMOQ
FXUMOW	FXUMOW
FXUQOP	FXUQOP
FXYKOA	FXYKOA
FXYKOC	FXYKOC
FXYKOE	FXYKOE
FXYKOF	FXYKOF
FXYKOG	FXYKOG
FXYKOP	Currency Warrant Aud/jpy
FXYKOQ	FXYKOQ
FXYKOR	FXYKOR
FXYKOS	FXYKOS
FXYKOW	FXYKOW
FXZKOB	FXZKOB
FXZKOF	FXZKOF
FXZKOQ	FXZKOQ
FXZKOR	FXZKOR
FXZKOS	FXZKOS
FXZKOU	FXZKOU
FZR	Fitzroy River Corporation Ltd
G11	G11 Resources Limited
G1A	Galena Mining Limited
G200	G200
G50	Gold 50 Limited
G6M	Group 6 Metals Limited
G88	Golden Mile Resources Ltd
G88OA	G88OA
GAL	Galicia Energy Corporation Ltd
GAP	Gale Pacific Ltd
GAS	GasNet Australia Group
GBE	Globe Uranium Ltd
GBR	G Retail Ltd
GBZ	GBM Resources Ltd
GC1	Glennon Small Companies Limited
GC1PA	GC1PA
GCAP	GCAP
GCI	Gryphon Capital Income Trust
GCM	Garda Capital Group
GCO2	GCO2
GCR	Golden Cross Resources Ltd
GDA	Gondwana Resources Ltd
GDC	Global Data Centre Group
GDF	Garda Diversified Property Fund
GDG	Generation Development Group Limited
GDI	Gdi Property Group
GDM	Goldstream Mining NL
GDX	Vaneck Vectors Gold Miners
GEAR	Betashares Geared Australian Equity
GED	Golden Deeps Ltd
GEM	G8 Education Limited
GEMKOC	G8 Education Limited
GEN	Genesis Research & Devlpmnt Corp Ltd
GES	Genesis Resources Limited
GFL	Global Masters Fund Ltd
GFLGA	GFLGA
GGAB	GGAB
GGE	Grand Gulf Energy Ltd
GGEO	Grand Gulf Energy Limited
GGEOA	GGEOA
GGX	Gas2Grid Ltd
GHHF	GHHF
GHY	Gold Hydrogen Limited
GIB	Gibb River Diamonds Limited
GL1	Global Lithium Resources Limited
GLA	Gladiator Resources Ltd
GLB	Globe International Ltd
GLDN	GLDN
GLE	GLG Corp Ltd
GLH	Global Health Ltd
GLIN	Amp Global Infrastructure Securities (unhedged)
GLL	Galilee Energy Limited
GLN	Gleneagle Gold Ltd
GLNOB	GLNOB
GLOB	GLOB
GLPR	GLPR
GMD	Genesis Minerals Ltd
GMG	Goodman Group
GMGKOA	Goodman Group
GMGKOB	Goodman Group
GML	Gateway Mining NL
GMN	Gold Mountain Limited
GMNO	GMNO
GMNOC	GMNOC
GMTL	GMTL
GNC	GrainCorp Ltd
GNCKOB	Graincorp Limited
GNCKOD	Graincorp Limited
GNCKOE	Graincorp Limited
GNCKOF	Graincorp Limited
GNCKOG	GNCKOG
GNCKOP	GNCKOP
GNCKOQ	GNCKOQ
GNCKOR	GNCKOR
GNE	Genesis Energy Limited
GNG	Gr Engineering Services Limited
GNM	Gujarat NRE Minerals Ltd
GNMOC	GNMOC
GNP	Genusplus Group Ltd
GNX	Genex Power Limited
GOAT	GOAT
GOLD	Etfs Physical Gold
GOR	Gold Road Resources Limited
GOVT	Spdr??s&p?/asx Australian Government Bond Fund
GOW	Gowing Bros Ltd
GOZ	Growthpoint Properties Australia
GPEQ	GPEQ
GPR	Geopacific Resources NL
GPT	General Property Trust
GPTKOA	Gpt Group
GPTKOB	Gpt Group
GPTKOC	Gpt Group
GPTKOE	GPTKOE
GPTKOP	Gpt Group
GPTKOQ	Gpt Group
GPTKOR	Gpt Group
GQG	Gqg Partners Inc.
GR8	Great Dirt Resources Ltd
GRE	Greentech Metals Limited
GRL	Gawler Resources Ltd
GRLO	GRLO
GRR	Grange Resources Ltd
GRV	Greenvale Mining NL
GRX	Goodrich Resources Ltd
GSBG25	Australian Government Treasury Bonds
GSBG26	Australian Government Treasury Bonds
GSBG27	Australian Government Treasury Bonds
GSBG29	Australian Government Treasury Bonds
GSBG33	Australian Government Treasury Bonds
GSBG37	Australian Government Treasury Bonds
GSBK31	GSBK31
GSBK35	Australian Government Treasury Bonds
GSBK39	Australian Government Treasury Bonds
GSBK51	GSBK51
GSBK54	GSBK54
GSBQ26	GSBQ26
GSBU24	GSBU24
GSBU25	GSBU25
GSBU27	Australian Government Treasury Bonds
GSBU28	Australian Government Treasury Bonds
GSBU29	GSBU29
GSBU31	GSBU31
GSBU32	GSBU32
GSBU33	GSBU33
GSIC50	GSIC50
GSIO35	Australian Government Treasury Indexed Bonds
GSIO40	Australian Government Treasury Indexed Bonds
GSIQ25	Australian Government Treasury Indexed Bonds
GSIQ30	Australian Government Treasury Indexed Bonds
GSIU27	Australian Government Treasury Indexed Bonds
GSIU32	GSIU32
GSM	Golden State Mining Limited
GSN	Great Southern Mining Limited
GSS	Genetic Signatures Limited
GT1	Green Technology Metals Limited
GTE	Great Western Exploration Ltd
GTG	Genetic Technologies Ltd
GTH	Gathid Ltd
GTI	Globe Securities Ltd
GTK	Gentrack Group Limited
GTN	GTN Resources Ltd
GTR	GTI Resources Ltd
GTRO	GTRO
GUE	Global Uranium And Enrichment Ltd
GUL	Gullewa Ltd
GVF	Global Value Fund Limited
GW1	Greenwing Resources Ltd
GWA	Gwa Group Limited.
GWAKOB	Gwa Group Limited.
GWAKOQ	Gwa Group Limited.
GWR	Golden West Resources Ltd
GYG	Guzman Y Gomez Limited
H100	H100
H2G	H2G
HACK	Betashares Global Cybersecurity
HAL	Halo Technologies Holdings Ltd
HAR	Haranga Resources Limited
HARO	HARO
HAS	Hastings Rare Metals Ltd
HASO	Hastings Rare Metals Ltd
HAV	Havilah Resources NL
HAW	Hawthorn Resources Ltd
HCD	Huadu City Development Ltd
HCF	H&g High Conviction Limited
HCH	Hot Chili Limited
HCL	Highcom Limited
HCT	Holista Colltech Limited
HCW	Healthco Healthcare And Wellness Reit
HDN	Haddington Resources Ltd
HE8	Helios Energy Ltd
HETH	HETH
HEUR	Betashares Wisdomtree Europe (currency Hedged)
HFR	Highfield Resources Limited
HFY	Hubify Limited
HGBL	HGBL
HGEN	HGEN
HGH	Heartland Group Holdings Limited
HGL	Hudson Investment Group Ltd
HGO	Hillgrove Resources Ltd
HGV	Hygrovest Limited
HHIF	HHIF
HHR	Hartshead Resources Nl
HIO	Hawsons Iron Ltd
HIOO	HIOO
HIQ	Hitiq Limited
HIQO	HIQO
HIT	Hitech Group Australia Ltd
HJPN	Betashares Wisdomtree Japan (currency Hedged)
HJZP	HJZP
HLF	Halo Food Co. Limited
HLI	Hailian International Ltd
HLIKOC	HLIKOC
HLIKOP	HLIKOP
HLIKOQ	HLIKOQ
HLO	Helloworld Limited
HLS	Hillcrest Litigation Services Ltd
HLSKOA	Healius Ltd
HLSKOB	Healius Limited
HLSKOF	Healius Ltd
HLSKOQ	Healius Ltd
HLSKOR	Healius Ltd
HLSKOS	Healius Ltd
HLSKOT	Healius Ltd
HLTH	HLTH
HLX	Helix Resources Ltd
HLXO	HLXO
HM1	Hearts And Minds Investments Limited
HMC	Hydromet Corporation Ltd
HMCO	Hydromet Corporation Ltd
HMD	Heramed Limited
HMG	Hamelin Gold Limited
HMI	Harvest Minerals Ltd
HMX	Hammer Metals Limited
HMY	Harmoney Corp Limited
HNDQ	HNDQ
HNG	HGL Ltd
HOR	Horseshoe Metals Limited
HPC	The Hydration Pharmaceuticals Company Limited
HPG	Hipages Group Holdings Ltd
HPI	Hotel Property Investments
HPP	Health And Plant Protein Group Limited
HPR	High Peak Royalties Limited
HQLT	HQLT
HRE	Heavy Rare Earths Limited
HRN	Horizon Gold Limited
HRZ	Horizon Energy Investment Group
HRZOB	Horizon Minerals Limited
HSN	Hansen Technologies Ltd
HT8	Harris Technology Group Limited
HTA	Hutchison Telecommunications (Aust)
HTG	Harvest Technology Group Ltd
HTM	Heritage Gold NZ Ltd
HTMO	HTMO
HUB	Hub24 Limited
HUBKOA	HUBKOA
HUBKOB	HUBKOB
HUBKOP	HUBKOP
HUM	Humanis Group Limited
HVLU	HVLU
HVN	Harvey Norman Holdings Ltd
HVNKOB	Harvey Norman Holdings Limited
HVNKOC	Harvey Norman Holdings Limited
HVNKOD	Harvey Norman Holdings Limited
HVNKOE	Harvey Norman Holdings Limited
HVNKOQ	Harvey Norman Holdings Limited
HVNKOW	Harvey Norman Holdings Limited
HVST	Betashares Australian Dividend Harvester Fund (man
HVY	Heavy Minerals Limited
HXG	Hexagon Resources Limited
HXL	Hexima Ltd
HYD	Hydrix Limited
HYGG	HYGG
HYT	Hyterra Ltd
HYTO	HYTO
HYTOA	HYTOA
HZN	Horizon Oil Ltd
HZR	Hazer Group Limited
HZRO	Hazer Group Limited
I88	Infini Resources Limited
IAA	Ishares Asia 50
IAF	Ishares Core Composite Bond
IAG	Insurance Australia Group Ltd
IAGKOA	Insurance Australia Group Limited
IAGKOB	Insurance Australia Group Limited
IAGKOD	Insurance Australia Group Limited
IAGKOQ	Insurance Australia Group Limited
IAGKOT	Insurance Australia Group Limited
IAGPE	IAGPE
IAGPF	IAGPF
IAM	Intiger Group Limited
IAMOB	IAMOB
IBAL	IBAL
IBC	Ironbark Capital Ltd
IBG	Ironbark Gold Ltd
IBGO	Ironbark Zinc Ltd
IBX	Imagion Biosystems Limited
ICE	ICE Corporation Ltd
ICG	Inca Minerals Limited
ICGOD	ICGOD
ICGOE	ICGOE
ICGOF	ICGOF
ICI	Icandy Interactive Limited
ICL	International Coal Holdings Limited
ICLO	ICLO
ICN	Icon Energy Ltd
ICOR	ICOR
ICR	Intelicare Holdings Limited
ICRO	ICRO
ICU	Isentric Limited
ID8	Identitii Limited
ID8O	ID8O
IDA	Indiana Resources Limited
IDT	Institute of Drug Technology Aust
IDX	Indexshares Fund The
IEAT	IEAT
IEC	Intra Energy Corporation Limited
IEL	Idp Education Limited
IELKOA	IELKOA
IELKOP	Idp Education Limited
IELKOQ	Idp Education Limited
IELKOR	IELKOR
IEM	Ishares Msci Emerging Markets
IEQ	International Equities Corp Ltd
IESG	IESG
IEU	Ishares Europe
IFL	IOOF Holdings Ltd
IFLKOA	Ioof Holdings Limited
IFLKOD	Ioof Holdings Limited
IFLKOP	Ioof Holdings Limited
IFLKOQ	Ioof Holdings Limited
IFM	Infomedia Ltd
IFRA	Vaneck Vectors Ftse Global Infrastructure (hedged)
IFT	Infratil Limited.
IG6	International Graphite Limited
IGB	Ishares Treasury
IGL	International Goldfields Ltd
IGN	Ignite Limited
IGO	Independence Group NL
IGOKOA	Independence Group Nl
IGOKOC	Independence Group Nl
IGOKOD	Independence Group Nl
IGOKOP	Independence Group Nl
IGOKOQ	Independence Group Nl
IGOKOR	Independence Group Nl
IGRO	IGRO
IHCB	Ishares Core Global Corporate Bond (aud Hedged)
IHD	Ishares S&p/asx Dividend Opportunities
IHEB	Ishares J.p. Morgan Usd Emerging Markets Bond (aud
IHOO	Ishares Global 100 Aud Hedged
IHWL	Ishares Core Msci World All Cap (aud Hedged)?
IIGF	IIGF
IIQ	Inoviq Ltd
IIQO	IIQO
IJH	Ishares Core S&p Mid-cap
IJP	Ishares Msci Japan
IJR	Ishares Core S&p Small-cap
IKE	Ikegps Group Limited
IKO	Ishares Msci South Korea Capped
ILA	Island Pharmaceuticals Limited
ILAO	ILAO
ILB	Ishares Government Inflation
ILC	Ishares S&p/asx 20
ILT	Iltani Resources Limited.
ILU	Iluka Resources Ltd
ILUKOA	Iluka Resources Limited
ILUKOB	Iluka Resources Limited
ILUKOC	Iluka Resources Limited
ILUKOE	Iluka Resources Limited
ILUKOP	Iluka Resources Limited
ILUKOQ	Iluka Resources Limited
ILUKOT	Iluka Resources Limited
ILUKOU	Iluka Resources Limited
IMA	Image Resources NL
IMB	Intelligent Monitoring Group Limited
IMC	
IMD	Imdex Ltd
IME	Imexhs Limited
IMI	IM Medical Ltd
IMLC	IMLC
IMM	Immutep Limited
IMPQ	IMPQ
IMR	Imricor Medical Systems Inc.
IMU	Imugene Ltd
IMUOD	IMUOD
IMUOE	IMUOE
INA	Ingenia Communities Group
INCM	Betashares Global Income Leaders
IND	Indus Energy Nl
INF	Infosentials
ING	Inghams Group Limited
INGKOC	Inghams Group Limited
INGKOD	INGKOD
INGKOP	Inghams Group Limited
INGKOQ	Inghams Group Limited
INGKOS	INGKOS
INGKOT	INGKOT
INIF	INIF
INL	Intec Ltd
INP	Innamincka Petroleum Ltd
INR	India Nre Minerals Ltd
INV	InvestorInfo Ltd
IOD	Iodm Limited
ION	ION Ltd
IOO	Ishares Global 100
IOZ	Ishares Core S&p/asx 200
IPB	Ipb Petroleum Limited
IPC	Imperial Pacific Limited
IPD	Impedimed Ltd
IPG	Investa Property Group
IPH	Ipoh
IPHKOA	Iph Limited
IPHKOB	Iph Limited
IPHKOD	Iph Limited
IPL	Incitec Pivot Ltd
IPLKOA	Incitec Pivot Limited
IPLKOB	Incitec Pivot Limited
IPLKOD	Incitec Pivot Limited
IPLKOE	Incitec Pivot Limited
IPLKOF	Incitec Pivot Limited
IPLKOG	Incitec Pivot Limited
IPLKOH	Incitec Pivot Limited
IPLKOP	Incitec Pivot Limited
IPLKOQ	Incitec Pivot Limited
IPLKOR	Incitec Pivot Limited
IPLKOT	Incitec Pivot Limited
IPLKOU	Incitec Pivot Limited
IPT	Impact Minerals Ltd
IPTO	Impact Minerals Limited
IPX	Intrapower Ltd
IR1	Iris Metals Limited
IRD	Iron Road Ltd
IRE	IRESS Market Technology Ltd
IREKOA	Iress Limited
IREKOB	Iress Limited
IREKOQ	Iress Limited
IREKOR	Iress Limited
IRI	Integrated Research Ltd
IRX	Inhalerx Limited
IS3	I Synergy Group Limited
ISEC	Ishares Enhanced Cash
ISLM	ISLM
ISO	Ishares S&p/asx Small Ordinaries
ITEK	ITEK
ITM	Itech Minerals Ltd
IUSG	IUSG
IVE	Ishares Msci Eafe
IVR	IVR
IVRO	Investigator Resources Ltd
IVT	Inventis Ltd
IVV	Ishares Core S&p 500
IVX	Invion Limited
IVZ	Invictus Energy Ltd
IVZOA	IVZOA
IXC	Invex Therapeutics Ltd
IXI	Ishares Global Consumer Staples
IXJ	Ishares Global Healthcare
IXR	IMX Resoures NL
IXU	Ixup Limited
IZZ	Ishares China Large-cap
JAL	Jameson Resources Ltd
JAN	Janison Education Group Limited
JAT	
JATO	Jatoil Limited
JAV	Javelin Minerals Limited
JAVOA	JAVOA
JAY	Jayride Group Limited
JBH	JB Hi-Fi Ltd
JBHKOA	Jb Hi-fi Limited
JBHKOB	Jb Hi-fi Limited
JBHKOC	Jb Hi-fi Limited
JBHKOG	Jb Hi-fi Limited
JBHKOQ	Jb Hi-fi Limited
JBHKOT	Jb Hi-fi Limited
JBHKOU	Jb Hi-fi Limited
JBY	James Bay Minerals Limited
JCS	Jcurve Solutions Ltd
JDO	Judo Capital Holdings Limited
JDOPA	JDOPA
JEGA	JEGA
JGH	Jade Gas Holdings Limited
JGLO	JGLO
JHGA	JHGA
JHLO	JHLO
JHX	James Hardie Industries NV (CUFS)
JHXKOA	James Hardie Industries Se
JHXKOD	James Hardie Industries Plc
JHXKOP	James Hardie Industries Se
JHXKOQ	James Hardie Industries Se
JHXKOR	James Hardie Industries Se
JIN	JIN
JLG	Johns Lyng Group Limited
JLL	Jindalee Lithium Limited
JMS	Jupiter Mines Ltd
JNDQ	JNDQ
JNO	Juno Minerals Limited
JPEQ	JPEQ
JPHQ	JPHQ
JPR	Jupiter Energy Ltd
JREG	JREG
JRHG	JRHG
JRV	Jervois Mining Ltd
JTL	Jayex Technology Limited
JYC	Joyce Corporation Ltd
JZRO	JZRO
K2F	K2fly Limited
KAI	Kairos Minerals Limited
KAL	Kalgoorlie-Boulder Resources Ltd
KAM	K2 Asset Management Holdings Ltd
KAR	Karoon Gas Australia Ltd
KARKOC	Karoon Gas Australia Limited
KARKOD	Karoon Gas Australia Limited
KARKOR	Karoon Gas Australia Limited
KARKOU	Karoon Gas Australia Limited
KARKOV	Karoon Gas Australia Limited
KAT	Katana Capital Ltd
KATO	KATO
KAU	Kaiser Reef Limited
KBC	Keybridge Capital Ltd
KCC	Kincora Copper Limited
KCN	Kingsgate Consolidated Ltd
KDY	Kaddy Limited
KED	Keypath Education International Inc.
KEY	Key Petroleum Ltd
KFM	Kingfisher Mining Ltd
KFMO	KFMO
KGD	Kula Gold Limited
KGL	Kentor Gold Ltd
KGN	Kogan.com Ltd
KIN	Kin Mining Nl
KKC	Kkr Credit Income Fund
KKO	Kinetiko Energy Ltd
KLI	Killi Resources Limited
KLR	Kaili Resources Limited
KLS	Kanowna Lights Nl
KM1	Kali Metals Limited
KMD	Kathmandu Holdings Limited
KME	Kip McGrath Education Centres
KNB	Koonenberry Gold Limited
KNBO	KNBO
KNG	Kingsland Minerals Ltd
KNGO	KNGO
KNI	Kuniko Limited
KNM	Kneomedia Limited
KNO	Knosys Limited
KOB	Koba Resources Limited
KOR	Korab Resources Ltd
KOV	Korvest Ltd
KP2	Kore Potash Plc
KPG	Kelly Partners Group Holdings Limited
KPO	Kalina Power Limited
KRM	Kingsrose Mining Ltd
KRR	King River Resources Limited
KSC	K&S Corporation Ltd
KSL	Kina Securities Limited
KSM	Kingstream Steel
KSN	Kingston Resources Limited
KTA	Krakatoa Resources Limited
KYP	Kinatico Ltd
KZR	Kalamazoo Resources Limited
L1IF	L1IF
L1M	Lightning Minerals Ltd
L1MO	L1MO
LAM	Laramide Resources Ltd
LAT	Latin Gold Ltd
LAU	Lindsay Australia Ltd
LAW	Lawfinance Limited
LBL	Laserbond Ltd
LBT	Labtech Systems Ltd
LBTO	Labtech Systems Ltd
LBTOA	Labtech Systems Ltd
LCE	London City Equities Ltd
LCL	Lighting Corporation Ltd
LCLO	LCLO
LCY	Legacy Iron Ore Ltd
LDR	Lach Drummond Resources Ltd
LDRO	Lode Resources Ltd
LDX	Lumos Diagnostics Holdings Limited
LEG	Legend Mining Ltd
LEL	Lion Equities
LEX	Lefroy Exploration Limited
LFG	Liberty Financial Group
LFS	Latitude Group Holdings Limited
LFSPA	LFSPA
LGI	Lgi Limited
LGL	Lihir Gold Ltd
LGM	Luiri Gold Limited
LGMO	LGMO
LGP	Little Green Pharma Ltd
LHM	Land & Homes Group Limited
LIC	Lifestyles Communities Ltd
LICKOA	LICKOA
LIN	Lindian Resources Ltd
LIO	Lion Energy Ltd
LIOOA	LIOOA
LIS	Li-s Energy Limited
LIT	Lithium Australia Nl
LITOA	LITOA
LITOB	Lithium Australia Limited
LKE	Lake Resources NL
LKY	Locksley Resources Limited
LLC	Lend Lease Corporation Ltd
LLCKOA	Lend Lease Group
LLCKOB	Lend Lease Group
LLCKOR	Lend Lease Group
LLCKOS	Lend Lease Group
LLCKOV	Lend Lease Group
LLI	Loyal Lithium Limited
LLL	Leo Lithium Limited
LLO	Lion One Metals Limited
LM1	Leeuwin Metals Ltd
LM8	Lunnon Metals Limited
LMG	Latrobe Magnesium Ltd
LML	Lincoln Minerals Ltd
LMS	Litchfield Minerals Limited
LNR	Lonestar Resources Limited
LNRO	Lanthanein Resources Ltd
LNU	Linius Technologies Limited
LNW	Light & Wonder Inc.
LNYN	LNYN
LOM	Lonrho Mining Ltd
LOT	Lotus Resources Limited
LOV	Lovisa Holdings Limited
LOVKOB	Lovisa Holdings Limited
LOVKOC	Lovisa Holdings Limited
LOVKOD	LOVKOD
LOVKOE	LOVKOE
LPD	Lepidico Ltd
LPDO	Lepidico Ltd
LPDOE	LPDOE
LPE	Locality Planning Energy Holdings Ltd
LPM	Loop Mobile Ltd
LRD	Lord Resources Limited
LRDO	Lord Resources Limited
LRK	Lark Distilling Co. Ltd
LRL	Leyshon Resources Ltd
LRS	Latin Resources Limited
LRT	Lowell Resources Fund
LRV	Larvotto Resources Limited
LRVO	LRVO
LSA	Lachlan Star Ltd
LSF	L1 Long Short Fund Limited
LSR	Lodestar Minerals Ltd
LSX	Lion Selection Group Limited.
LTM	Arcadium Lithium Plc
LTP	Ltr Pharma Limited
LTR	Liontown Resources Ltd
LTRKOA	LTRKOA
LTRKOD	Liontown Resources Limited
LTRKOG	LTRKOG
LTRKOP	LTRKOP
LTRKOQ	LTRKOQ
LTRKOR	LTRKOR
LU7	Lithium Universe Limited
LU7O	LU7O
LV1	Live Verdure Ltd
LV1OA	LV1OA
LVE	Love Group Global Ltd
LVH	Livehire Limited
LVT	Livetiles Limited
LYC	Lynas Corporation Ltd
LYCKOA	Lynas Corporation Limited
LYCKOB	Lynas Corporation Limited
LYCKOC	Lynas Corporation Limited
LYCKOP	Lynas Corporation Limited
LYCKOQ	Lynas Corporation Limited
LYCKOS	Lynas Corporation Limited
LYCKOT	Lynas Corporation Limited
LYCKOU	Lynas Corporation Limited
LYCKOV	Lynas Corporation Limited
LYK	Lykos Metals Limited
LYKOA	LYKOA
LYL	Lycopodium Ltd
LYN	Lycaon Resources Ltd
M24	Mamba Exploration Limited
M2M	Mt Malcolm Mines Nl
M2MO	M2MO
M2R	Miramar Resources Limited
M2RO	Miramar Resources Limited
M2ROA	M2ROA
M3M	M3 Mining Limited
M4M	Macro Metals Limited
M4MOB	M4MOB
M7T	Mach7 Technologies Limited
M8S	M8 Sustainable Limited
MAC	Macro Corporation Ltd
MAD	Maverick Drilling And Exploration Limited
MAET	MAET
MAF	Ma Financial Group Limited
MAG	Magellan Petroleum Australia Ltd
MAH	Macmahon Holdings Ltd
MAM	Aii S&p/asx 300 Metals & Mining
MAN	Magna Mining Ltd
MAP	Macquarie Airports
MAQ	Macquarie Telecom Group Ltd
MAT	Matine Ltd t/over
MAU	Magnetic Resources NL
MAUCA	Magnetic Resources Nl
MAY	Mayne Group Ltd
MBH	Maggie Beer Holdings Ltd
MBK	Metal Bank Limited
MBLPC	MBLPC
MBLPD	MBLPD
MBX	mBox.com
MCA	Medica Holdings
MCCL	MCCL
MCE	Matrix Composites & Engineering Limited
MCGG	MCGG
MCL	M2M Corporation Ltd
MCM	Mc Mining Limited
MCP	McPhersons Ltd
MCT	Metalicity Limited
MCY	Mighty River Power Limited.
MDC	McConnell Dowell Corporation
MDI	Middle Island Resources Limited
MDR	Medadvisor Limited
MDX	Mindax Ltd
ME1	Melodiol Global Health Limited
ME1O	ME1O
ME1OD	ME1OD
ME1OE	ME1OE
MEC	Morphic Ethical Equities Fund Limited
MEG	MCM Entertainment Group Ltd
MEI	Meteoric Resources NL
MEK	Meeka Gold Limited
MEL	Metgasco Ltd
MELOB	MELOB
MEM	Memphasys Limited.
MEU	Maramota Energy Ltd
MEZ	Meridian Energy Limited
MFD	Mayfield Childcare Limited
MFF	Magellan Flagship Fund Ltd
MFG	Magellan Financial Group
MFGKOA	Magellan Financial Group Limited
MFGKOB	Magellan Financial Group Limited
MFGKOC	Magellan Financial Group Limited
MFGKOP	Magellan Financial Group Limited
MFGKOQ	Magellan Financial Group Limited
MFGKOR	Magellan Financial Group Limited
MFGO	MFGO
MFOA	MFOA
MGA	Metalsgrove Mining Ltd
MGAO	MGAO
MGF	Magellan Global Fund.
MGH	Maas Group Holdings Limited
MGL	Magontec Limited
MGOC	MGOC
MGR	Mirvac Group
MGRKOB	Mirvac Group
MGRKOC	Mirvac Group
MGRKOE	MGRKOE
MGRKOP	Mirvac Group
MGRKOQ	Mirvac Group
MGRKOR	Mirvac Group
MGT	Magnetite Mines Limited.
MGTO	MGTO
MGU	Magnum Gold NL
MGUO	Magnum Mining And Exploration Limited
MGX	Mount Gibson Iron Ltd
MGXKOJ	Mount Gibson Iron Limited
MHC	Manhattan Corporation Limited
MHG	Magellan Global Equities Fund (currency Hedged)
MHHT	MHHT
MHI	Merchant House International Ltd
MHJ	Michael Hill International Limited
MHK	Metal Hawk Limited.
MHOT	MHOT
MI6	Minerals 260 Limited
MICH	MICH
MIN	Mineral Resources Ltd
MINKOC	Mineral Resources Limited
MINKOE	Mineral Resources Limited
MINKOF	Mineral Resources Limited
MINKOH	Mineral Resources Limited
MINKOQ	Mineral Resources Limited
MINKOX	Mineral Resources Limited
MINKOY	MINKOY
MIO	Miclyn Express Offshore Limited
MIOO	MIOO
MIR	Mirrabooka Investments Ltd
MKG	Mako Gold Limited
MKL	Mighty Kingdom Limited
MKR	Manuka Resources Ltd.
MKT	The Market Limited
MLG	Mlg Oz Limited
MLM	Metallica Minerals Ltd
MLS	Metals Australia Ltd
MLX	Metals X Ltd
MM1	Midas Minerals Ltd
MM8	Medallion Metals Limited.
MMA	MMC Contrarian Ltd
MMC	Marengo Mining Canada Limited
MME	MTM Entertainment Trust
MMI	Metro Mining Limited
MMKT	MMKT
MMM	Marley Spoon Ag
MMR	Mec Resources Ltd
MMS	McMillan Shakespeare Ltd
MMSKOB	Mcmillan Shakespeare Limited
MMSKOC	Mcmillan Shakespeare Limited
MNB	Minbos Resources Limited
MNBOB	MNBOB
MND	Monadelphous Group Ltd
MNDKOA	Monadelphous Group Limited
MNDKOC	Monadelphous Group Limited
MNDKOP	Monadelphous Group Limited
MNDKOQ	Monadelphous Group Limited
MNDKOT	Monadelphous Group Limited
MNS	Milnes Holdings
MOAT	Vaneck Vectors Morningstar Wide?moat
MOGL	MOGL
MOH	Moho Resources Limited
MOM	Moab Minerals Limited
MOT	Motopia Limited
MOV	Moore Australasia (holdings) Limited
MOZ	Mozambi Coal Limited
MOZG	MOZG
MP1	Megaport Limited
MP1KOB	MP1KOB
MP1KOD	MP1KOD
MP1KOF	MP1KOF
MPA	Marine Produce Australia Ltd
MPK	Many Peaks Minerals Ltd
MPL	Medibank Private Limited
MPLKOE	Medibank Private Limited
MPLKOP	Medibank Private Limited
MPLKOS	Medibank Private Limited
MPP	Metro Performance Glass Limited
MPR	Macquarie ProLogis Trust
MPRO	Mpower Group Limited
MPX	Mustera Property Group Limited
MQDB	MQDB
MQEG	MQEG
MQG	Macquarie Group Ltd
MQGKOA	Macquarie Group Limited
MQGKOB	Macquarie Group Limited
MQGKOC	Macquarie Group Limited
MQGKOD	Macquarie Group Limited
MQGKOG	Macquarie Group Limited
MQGKOI	Macquarie Group Limited
MQGKOJ	Macquarie Group Limited
MQGKOK	Macquarie Group Limited
MQGKOP	Macquarie Group Limited
MQGKOS	Macquarie Group Limited
MQGKOT	Macquarie Group Limited
MQGKOW	Macquarie Group Limited
MQGKOZ	Macquarie Group Limited
MQGMOA	Macquarie Group Limited
MQGMOQ	Macquarie Group Limited
MQGMOR	Macquarie Group Limited
MQGPC	Macquarie Group Limited
MQGPD	Macquarie Group Limited
MQGPE	MQGPE
MQGPF	Macquarie Group Limited
MQIO	MQIO
MQR	Marquee Resources Limited
MRC	Mineral Commodities Ltd
MRD	Mount Ridley Mines Limited
MRI	MRI Holdings Ltd
MRL	Miller's Retail Ltd
MRM	Mermaid Marine Australia Ltd
MRQ	Mrg Metals Limited
MRQO	Mrg Metals Limited
MRR	Minrex Resources Nl
MRZ	Mirvac Real Estate Investment Trust
MSB	Mesoblast Ltd
MSG	Mcs Services Limited
MSI	Multistack International Ltd
MSTR	MSTR
MSV	Mitchell Services Limited
MTB	Mount Burgess Mining NL
MTC	Metalstech Limited
MTH	Mithril Resources Ltd
MTHO	Mithril Resources Limited
MTL	Manalto Limited
MTM	Mareterram Limited
MTMO	MTMO
MTO	Moto Goldmines Ltd
MTS	Metcash Ltd
MTSKOA	Metcash Limited
MTSKOB	Metcash Limited
MTSKOE	Metcash Limited
MTSKOP	Metcash Limited
MTSKOQ	Metcash Limited
MTSKOR	Metcash Limited
MTUM	MTUM
MVA	Vaneck Vectors Australian?property
MVB	Vaneck Vectors Australian Banks
MVE	Vaneck Vectors S&p/asx Midcap
MVF	Monash Ivf Group Limited
MVL	Microview Ltd
MVOL	Ishares Edge Msci Australia Minimum Volatility
MVP	Medical Developments International
MVPO	Medical Developments International Limited
MVR	Vaneck Vectors Australian Resources
MVS	Vaneck Vectors Small Cap Dividend?payers
MVW	Vaneck Vectors Australian Equal Weight
MWY	Midway Limited
MX1	Micro-x Limited
MXI	MaxiTRA Industries Ltd
MXO	Matrix Oil
MXR	Maximus Resources Ltd
MXT	Mcp Master Income Trust
MYE	Mastermyne Group Limited
MYG	Mutiny Gold Ltd
MYR	Myer Holdings Limited
MYS	Mystate Limited
MYX	MYX
N100	N100
N1H	N1 Holdings Limited
NAB	National Australia Bank Ltd
NABKOA	National Australia Bank Limited
NABKOB	National Australia Bank Limited
NABKOC	National Australia Bank Limited
NABKOD	National Australia Bank Limited
NABKOF	National Australia Bank Limited
NABKOG	National Australia Bank Limited
NABKOH	National Australia Bank Limited
NABKOJ	National Australia Bank Limited
NABKOK	National Australia Bank Limited
NABKOL	National Australia Bank Limited
NABKOP	National Australia Bank Limited
NABKOQ	National Australia Bank Limited
NABKOR	National Australia Bank Limited
NABKOT	National Australia Bank Limited
NABKOV	National Australia Bank Limited
NABKOY	National Australia Bank Limited
NABKOZ	National Australia Bank Limited
NABMOS	NABMOS
NABPF	National Australia Bank Limited
NABPH	NABPH
NABPI	National Australia Bank Limited
NABPJ	NABPJ
NABPK	NABPK
NAC	Naos Absolute Opportunities Company Limited
NACGA	NACGA
NACO	Naos Absolute Opportunities Company Limited
NAE	New Age Exploration Ltd
NAG	
NAGO	NAGO
NAM	Namoi Cotton Co-operative Ltd
NAN	Nanosonics Ltd
NANKOB	Nanosonics Limited
NANKOR	NANKOR
NC1	Nico Resources Limited
NC6	Nanollose Limited
NC6OB	NC6OB
NCC	Naos Emerging Opportunities Company Limited
NCCGA	NCCGA
NCCO	Naos Emerging Opportunities Company Limited
NCK	Nick Scali Ltd
NCR	Nucoal Resources Nl
NDIA	NDIA
NDO	Nido Petroleum Ltd
NDQ	Betashares Nasdaq 100
NDXKOB	Nasdaq 100 E-mini
NDXKOC	NDXKOC
NDXKOE	NDXKOE
NDXKOJ	NDXKOJ
NDXKOK	NDXKOK
NDXKOM	NDXKOM
NDXKON	NDXKON
NDXKOO	NDXKOO
NEC	Nine Entertainment Co Holdings Ltd
NECKOA	Nine Entertainment Co. Holdings Limited
NECKOB	Nine Entertainment Co. Holdings Limited
NECKOP	Nine Entertainment Co. Holdings Limited
NECKOS	Nine Entertainment Co. Holdings Limited
NEM	Newmont Mining Corporation (US CUFS)
NES	Nelson Resources Limited.
NET	Netlinkz Limited
NEU	Neuren Pharmaceuticals Ltd
NEUKOA	NEUKOA
NFL	Natural Fuel Ltd
NFLO	NFLO
NFNG	NFNG
NGE	New Guinea Energy Ltd
NGI	Navigator Global Investments Limited
NGL	Nightingale Intelligent Systems Inc
NGLO	NGLO
NGS	Nutritional Growth Solutions Ltd
NGSOA	NGSOA
NGX	Norseman Gold Plc
NGY	Nuenergy Capital Ltd
NHC	New Hope Corporation Ltd
NHCKOA	New Hope Corporation Limited
NHCKOB	New Hope Corporation Limited
NHCKOP	New Hope Corporation Limited
NHCKOQ	New Hope Corporation Limited
NHCKOR	New Hope Corporation Limited
NHE	New Horizon Energy Ltd
NHEO	Noble Helium Limited
NHEOA	NHEOA
NHF	Nib Holdings Ltd
NHFKOA	Nib Holdings Limited
NHFKOC	Nib Holdings Limited
NHFKOE	NHFKOE
NHFKOF	NHFKOF
NHFKOP	Nib Holdings Limited
NHFKOQ	Nib Holdings Limited
NI2KOA	NI2KOA
NI2KOD	NI2KOD
NI2KOF	NI2KOF
NI2KOG	NI2KOG
NI2KOI	NI2KOI
NI2KOJ	NI2KOJ
NI2KOQ	NI2KOQ
NI2KOS	NI2KOS
NI2KOT	NI2KOT
NI2KOZ	NI2KOZ
NI2MOP	NI2MOP
NIC	Nickel Mines Limited
NICKOA	NICKOA
NICKOC	NICKOC
NICKOE	NICKOE
NIM	Nimy Resources Limited
NIS	Nickelsearch Limited
NKL	Nickel Australia Ltd
NKLO	NKLO
NME	Nex Metals Exploration Ltd
NML	Navarre Minerals Limited
NMR	Nimrodel Resources Ltd
NMT	Neometals Ltd
NNG	Northern Gold NL
NNGO	NNGO
NNL	Nordic Nickel Limited
NNUK	NNUK
NOL	National 1
NOR	Norwood Systems Limited
NOROD	NOROD
NOU	Noumi Limited
NOUO	NOUO
NOV	Novatti Group Limited
NOVO	NOVO
NOX	Noxopharm Limited
NPM	Newpeak Metals Limited
NRX	Noronex Limited
NRXO	NRXO
NRZ	Neurizer Ltd
NRZO	NRZO
NRZOA	NRZOA
NSB	Neuroscientific Biopharmaceuticals Ltd
NSC	Naos Small Cap Opportunities Company Limited
NSM	North Stawell Minerals Ltd
NSR	National Storage Reit
NSRKOA	National Storage Reit
NSRKOB	National Storage Reit
NST	Northern Star Resources Ltd
NSTKOA	Northern Star Resources Ltd
NSTKOB	Northern Star Resources Ltd
NSTKOC	Northern Star Resources Ltd
NSTKOD	Northern Star Resources Ltd
NSTKOE	Northern Star Resources Ltd
NSTKOF	NSTKOF
NSTKOP	Northern Star Resources Ltd
NSTKOQ	Northern Star Resources Ltd
NSTKOV	NSTKOV
NSX	X Ltd
NTD	National Tyre & Wheel Limited
NTI	Neurotech International Limited
NTIOA	NTIOA
NTL	New Talisman Gold Mines Limited
NTM	Northern Manganese Limited
NTU	Northen Uranium Ltd
NUC	Nuchev Limited
NUF	NuFarm Ltd
NUFKOA	Nufarm Limited
NUFKOB	Nufarm Limited
NUFKOD	Nufarm Limited
NUFKOP	Nufarm Limited
NUFKOQ	Nufarm Limited
NUFKOR	Nufarm Limited
NUGG	NUGG
NUH	Nuheara Limited
NVA	Nova Minerals Limited
NVO	Nvoi Ltd
NVQ	Noviqtech Limited
NVU	Nanoveu Limited
NVX	Novonix Limited
NWC	New World Cobalt Limited
NWF	Newfield Resources Limited
NWH	NRW Holdings Ltd
NWHKOC	Nrw Holdings Limited
NWL	New Tel
NWLKOP	Netwealth Group Limited
NWLKOQ	NWLKOQ
NWLKOR	NWLKOR
NWM	Norwest Minerals Limited
NWMO	NWMO
NWS	News Corporation
NWSLV	NEWS CORP-PREFD
NXD	Nexted Group Limited
NXG	Nexgen Energy (canada) Ltd
NXL	Nuix Limited
NXM	Nexus Minerals Limited
NXMO	NXMO
NXS	Nexus Energy Ltd
NXT	Nextdc Limited
NXTKOA	Nextdc Limited
NXTKOB	Nextdc Limited
NXTKOE	Nextdc Limited
NXTKOQ	NXTKOQ
NXTKOR	Nextdc Limited
NYM	Narryer Metals Limited
NYR	Nyrada Inc.
NZK	New Zealand King Salmon Investments Limited
NZM	Nzme Limited
NZO	New Zealand Oil & Gas Ltd
NZS	New Zealand Coastal Seafoods Limited
NZSOB	New Zealand Coastal Seafoods Limited
OAK	Oaks Hotels & Resorts Ltd
OAR	Oakdale Resources Limited
OAU	Ora Gold Limited
OBL	Oil Basins Ltd
OBM	Ora Banda Mining Ltd
OCA	Oil Company Of Australia
OCC	Orthocell Limited
OCL	Objective Corporation Ltd
OCN	Oceana Lithium Limited
OCT	Octava Minerals Limited
OD6	Od6 Metals Limited
ODA	Orcoda Limited
ODE	Odessa Minerals Limited
ODEO	ODEO
ODY	Odyssey Energy Ltd
OEC	Orbital Corporation Ltd
OECO	OECO
OEL	Ottoman Energy Ltd
OEQ	Orion Equities Ltd
OFX	Ozforex Group Limited
OFXKOQ	Ozforex Group Limited
OFXKOR	Ozforex Group Limited
OIL	Optiscan Imaging Ltd
OJC	The Original Juice Co. Ltd
OKJ	Oakajee Corporation Ltd
OLH	Oldfields Holdings Ltd
OLI	Olivers Real Food Limited
OLL	Openlearning Limited
OLY	Olympia Resources Ltd
OM1	Omnia Metals Group Ltd
OM1O	OM1O
OMA	Omega Oil & Gas Limited
OMH	OM Holdings Ltd
OML	Ooh!media Limited
OMLKOA	Ooh!media Limited
OMX	Ormil Energy Limited
ONE	Oneview Healthcare Plc
OOO	Betashares Crude Oil Index Etf - Currency Hedged (
OPH	Ophir High Conviction Fund
OPL	Orchard Petroleum Ltd
OPN	Opendna Limited
OPNOA	OPNOA
OPT	Opthea Limited
OPTOA	OPTOA
OPTOB	OPTOB
ORA	Orora Limited
ORAKOA	Orora Limited
ORAKOB	Orora Limited
ORAKOP	Orora Limited
ORAKOQ	Orora Limited
ORD	Ord River Resources Ltd
ORG	Origin Energy Ltd
ORGKOA	Origin Energy Limited
ORGKOB	Origin Energy Limited
ORGKOC	Origin Energy Limited
ORGKOD	Origin Energy Limited
ORGKOP	Origin Energy Limited
ORGKOQ	Origin Energy Limited
ORGKOS	Origin Energy Limited
ORI	Orica Ltd
ORIKOB	Orica Limited
ORIKOC	Orica Limited
ORIKOD	Orica Limited
ORIKOP	Orica Limited
ORIKOR	Orica Limited
ORIKOT	Orica Limited
ORN	ORN
ORP	Oropa Ltd
OSL	Oncosil Medical Ltd
OSLO	OSLO
OSLOB	OSLOB
OSM	Osmond Resources Limited
OSX	Osteopore Limited
OSXO	OSXO
OVT	Ovato Limited
OXT	Orexplore Technologies Limited
OZF	Spdr??s&p?/asx 200 Financials Ex A-reit Fund
OZM	Ozaurum Resources Limited
OZR	Spdr??s&p?/asx 200 Resources Fund
OZZ	Ozz Resources Limited
OZZO	OZZO
PAA	PharmAust Ltd
PAAOA	PAAOA
PAB	Patrys Ltd
PAC	Pacsoft Ltd
PAI	Platinum Asia Investments Limited
PAM	Pan Asia Metals Limited
PAN	Panoramic Resources Ltd
PAR	Paradigm Biopharmaceuticals Limited..
PARO	PARO
PAT	Patriot Lithium Limited
PBH	Pointsbet Holdings Limited
PBL	Publishing & Broadcasting Ltd
PCG	PCH Group Ltd
PCI	Perpetual Credit Income Trust
PCK	Painchek Ltd
PCL	Pancontinental Oil & Gas NL
PCLO	Pancontinental Energy Nl
PCX	Pengana Global Private Credit Trust
PDI	Predictive Discovery Limited
PDN	Paladin Resources Ltd
PDNKOA	Paladin Energy Ltd
PDNKOB	Paladin Energy Ltd
PDNKOC	Paladin Energy Ltd
PDNKOD	Paladin Energy Ltd
PDNKOP	Paladin Energy Ltd
PDNKOR	Paladin Energy Ltd
PE1	Pengana Private Equity Trust
PEB	Pacific Edge Limited
PEC	Perpetual Resources Limited
PEK	Peak Resources Ltd
PEN	Peninsula Minerals Ltd
PER	Percheron Therapeutics Limited
PET	Peters MacGregor Investments Ltd
PEX	Peel Exploration Ltd
PFE	Pantera Minerals Limited
PFEO	PFEO
PFEOA	Pantera Minerals Limited
PFG	Prime Financial Group Ltd
PFP	WC Penfold
PFT	Pure Foods Tasmania Limited
PGC	Paragon Care Ltd
PGD	Peregrine Gold Ltd
PGDOA	PGDOA
PGF	Pm Capital Global Opportunities Fund Limited
PGH	Pact Group Holdings Ltd
PGL	Progen Industries Ltd
PGM	Platina Resources Ltd
PGO	Primary Gold Limited
PGOOB	PGOOB
PGY	Pilot Energy Limited
PGYO	Pilot Energy Limited
PH2	Pure Hydrogen Corporation Limited
PHL	Pearl Healthcare Ltd
PHO	Phoneware
PHX	Pharmx Technologies Limited
PIA	Prudential Investment Company Of Australia
PIC	Perpetual Equity Investment Company Limited
PIL	Pilbara Mines NL.
PIM	Prime Minerals Ltd
PIMO	Prime Minerals Ltd
PIQ	Proteomics International Laboratories Ltd
PKD	Parkd Ltd
PKO	Peak Oil & Gas Limited
PKOO	PKOO
PL3	Patagonia Lithium Ltd
PL3O	PL3O
PL8	Plato Income Maximiser Limited.
PLC	Plc Financial Solutions Limited
PLG	Propertylink Group
PLL	Poltech International
PLN	Planar Semiconductor Inc
PLS	Pilbara Minerals Limited
PLSKOA	PLSKOA
PLSKOC	PLSKOC
PLSKOG	PLSKOG
PLSKOP	PLSKOP
PLSKOQ	PLSKOQ
PLSKOS	PLSKOS
PLSKOU	PLSKOU
PLT	Polartechnics Ltd
PLY	Polymetals Mining Limited
PMC	Platinum Capital Ltd
PME	Pro Medicus Ltd
PMEKOA	Pro Medicus Limited
PMEKOB	Pro Medicus Limited
PMEKOC	Pro Medicus Limited
PMEKOD	Pro Medicus Limited
PMEKOE	Pro Medicus Limited
PMEKOF	PMEKOF
PMGOLD	Perth Mint Gold
PMT	Patriot Battery Metals Inc.
PMV	Premier Investments Ltd
PMVKOA	Premier Investments Limited
PMVKOB	Premier Investments Limited
PMVKOC	Premier Investments Limited
PMVKOQ	Premier Investments Limited
PMVKOR	Premier Investments Limited
PMVKOS	Premier Investments Limited
PNC	Pioneer Credit Limited
PNCO	Pioneer Credit Limited
PNI	Pinnacle Investment Management Group Ltd
PNM	Pacific Nickel Mines Limited
PNN	PeppinNini Minerals Ltd
PNNO	Pepinnini Minerals Limited
PNR	Pacific Niugini Minerals Ltd
PNT	Panther Metals Ltd
PNTO	PNTO
PNTOA	PNTOA
PNV	Polynovo Limited
PNVKOA	PNVKOA
PNVKOB	Polynovo Limited
PNVKOD	PNVKOD
PNX	Phoenix Copper Ltd
PO3	Purifloh Limited
POD	Podium Minerals Limited
PODOA	PODOA
POL	Polaris Metals NL
POS	Poseidon Nickel Ltd
POW	Protean Wave Energy Ltd
PPC	Peet & Company Ltd
PPE	People Infrastructure Ltd
PPG	Pro-Pac Packaging Ltd
PPK	Plaspak Group Ltd
PPL	Park Plaza Kemayan
PPM	Primero Mining Corp.
PPS	Praemium Ltd
PPT	Perpetual Trustees Australia Ltd
PPTKOD	Perpetual Limited
PPTKOE	Perpetual Limited
PPTKOF	Perpetual Limited
PPTKOU	PPTKOU
PPY	Papyrus Australia Ltd
PR1	Pure Resources Limited
PR1OA	Pure Resources Limited
PR2	Piche Resources Limited
PR2O	PR2O
PRG	Programmed Maintenance Services Ltd
PRL	Petrel Energy Limited
PRM	Plenty River Mining Corporation Ltd
PRN	Pelsart Resources Nl
PRO	Prophecy International Holdings Ltd
PRS	Prospech Limited.
PRSOA	PRSOA
PRU	Perseus Mining Ltd
PRUKOA	Perseus Mining Limited
PRUKOB	Perseus Mining Limited
PRUKOC	Perseus Mining Limited
PRUKOE	Perseus Mining Limited
PRX	Prime Retail Group unit/ord
PSC	Prospect Resources Limited
PSI	Pacific Strategic Investments Ltd
PSL	Panaseer
PSQ	Pacific Smiles Group Limited
PTL	Pental Limited
PTM	Platinum Asset Management Ltd
PTMKOP	Platinum Asset Management Limited
PTMKOS	Platinum Asset Management Limited
PTR	Petratherm Ltd
PTX	Prescient Therapeutics Limited
PUA	Pure Alumina Limited
PUR	Purus Energy Ltd
PV1	Provaris Energy Ltd
PVE	Po Valley Energy Ltd
PVL	Powerhouse Ventures Limited
PVT	Provet Holdings Limited
PVW	Pvw Resources Limited
PWH	Pwr Holdings Limited
PWN	Potash West Nl
PWR	Powerlan Ltd
PXA	Pexa Group Limited
PXAKOB	PXAKOB
PXX	Polarx Limited
PYC	Phylogica Ltd
QAL	Qualitas Limited
QAN	Qantas Airways Ltd
QANKOA	Qantas Airways Limited
QANKOB	Qantas Airways Limited
QANKOE	Qantas Airways Limited
QANKOF	Qantas Airways Limited
QANKOP	Qantas Airways Limited
QANKOQ	Qantas Airways Limited
QANKOR	Qantas Airways Limited
QANKOU	Qantas Airways Limited
QAU	Betashares Gold Bullion Etf - Currency Hedged
QBE	QBE Insurance Group Ltd
QBEKOA	Qbe Insurance Group Limited
QBEKOB	Qbe Insurance Group Limited
QBEKOC	Qbe Insurance Group Limited
QBEKOD	Qbe Insurance Group Limited
QBEKOF	Qbe Insurance Group Limited
QBEKOP	Qbe Insurance Group Limited
QBEKOR	Qbe Insurance Group Limited
QBEKOS	Qbe Insurance Group Limited
QBEKOT	Qbe Insurance Group Limited
QEM	Qem Limited
QFE	Quickfee Limited
QFN	Betashares S&p/asx 200 Financials Sector
QGL	Quantum Graphite Limited
QHAL	Vaneck Vectors Msci World Ex-australia Quality Hed
QHL	Quickstep Holdings Ltd
QHSM	QHSM
QIP	Qantm Intellectual Property Limited
QML	QMastor Ltd
QNDQ	QNDQ
QOR	Qoria Limited
QOZ	Betashares Ftse Rafi Australia 200
QPM	Queensland Pacific Metals Limited
QPON	Betashares Australian Bank Senior Floating Rate Bo
QRE	Betashares S&p/asx 200 Resources Sector
QRI	Qualitas Real Estate Income Fund
QSML	QSML
QUAL	Vaneck Vectors Msci World Ex-australia Quality
QUB	Qube Logistics
QUBKOA	Qube Holdings Limited
QUBKOC	Qube Holdings Limited
QUE	Queste Communications Ltd
QUS	Betashares Ftse Rafi U.s. 1000?
QVE	Qv Equities Limited
QXR	Qx Resources Limited
R8R	Regener8 Resources Nl
RAC	Reinsurance Australia Corporation
RAD	Radar Iron Limited
RADO	Radar Iron Limited
RAG	Ragnar Metals Limited
RAGO	RAGO
RAN	Range International Limited
RAS	Ragusa Minerals Ltd
RAU	Republic Gold Ltd
RB6	Rubix Resources Limited
RB6O	Rubix Resources Limited
RBD	Restaurant Brands New Zealand Limited
RBR	Rubicon Resources Ltd
RBTZ	Betashares Global Robotics And Artificial Intellig
RBX	Resources Base Ltd
RC1	Redcastle Resources Limited
RC1O	RC1O
RCAP	RCAP
RCB	Russell Australian Select Corporate Bond Etf
RCE	Recce Limited
RCL	Repco Corporation Ltd
RCR	RCR Tomlinson Ltd
RCT	Reef Casino Trust
RDG	Resource Development Group Limited
RDM	Red Metal Ltd
RDN	Raiden Resources Limited
RDNOA	RDNOA
RDS	Redstone Resources Ltd
RDV	Russell High Dividend Australian Shares
RDX	Redox Limited
RDY	Readytech Holdings Limited
REA	realestate.com.au Ltd
REAKOA	Rea Group Ltd
REAKOF	Rea Group Ltd
REAKOP	Rea Group Ltd
REC	Recall Holdings Limited
RED	Red 5 Ltd
REDKOB	REDKOB
REE	Rarex Limited
REEO	REEO
REG	RG Capital Radio
REGKOA	Regis Healthcare Limited
REGKOB	Regis Healthcare Limited
REH	Reece Australia Ltd
REHKOA	REHKOA
REHKOB	REHKOB
REHKOR	REHKOR
REIT	REIT
REM	Reliance Mining Ltd
REMO	REMO
REP	Ram Essential Services Property Fund
REX	Regional Express Holdings Ltd
REY	Rey Resources Ltd
REZ	Resources & Energy Group Limited
RF1	Regal Investment Fund
RFA	Rare Foods Australia Limited
RFF	Rural Funds Group
RFG	Retail Food Group Ltd
RFT	Rectifier Technologies Ltd
RFX	Redflow Limited
RG8	Regal Asian Investments Limited
RGB	Russell Australian Government Bond
RGL	Ruralco Holdings Ltd
RGN	Region Group
RGNKOA	RGNKOA
RGNKOB	RGNKOB
RGNKOC	RGNKOC
RGNKOP	RGNKOP
RGNKOR	RGNKOR
RGNKOS	RGNKOS
RGT	Argent Biopharma Limited
RHC	Ramsay Health Care Ltd
RHCKOB	Ramsay Health Care Limited
RHCKOC	Ramsay Health Care Limited
RHCKOQ	Ramsay Health Care Limited
RHCKOR	Ramsay Health Care Limited
RHCPA	Ramsay Health Care Ltd
RHI	Red Hill Iron Ltd
RHK	Red Hawk Mining Limited
RHT	Resonance Health Ltd
RHY	Rhythm Biosciences Limited
RHYO	RHYO
RIC	Ridley Corporation Ltd
RIE	Riedel Resources Limited
RIL	Redivium Limited
RIM	Rimfire Pacific Mining NL
RINC	RINC
RIO	Rio Tinto Ltd
RIOKOA	Rio Tinto Limited
RIOKOB	Rio Tinto Limited
RIOKOD	Rio Tinto Limited
RIOKOE	Rio Tinto Limited
RIOKOF	Rio Tinto Limited
RIOKOS	Rio Tinto Limited
RIOKOT	Rio Tinto Limited
RIOKOU	Rio Tinto Limited
RIOKOV	Rio Tinto Limited
RIOKOX	Rio Tinto Limited
RIOMOA	Rio Tinto Limited
RIOMOB	Rio Tinto Limited
RKN	Reckon Ltd
RKT	Rocketdna Ltd.
RLC	Revere Mining
RLF	Rlf Agtech Ltd
RLG	Rcl Group
RLT	Renergen Limited
RMC	RIMCapital Ltd
RMD	ResMed Inc (USA CUFS)
RMDKOE	Resmed Inc
RMI	Resource Mining Corporation Ltd
RML	Rusina Mining NL
RMS	Ramelius Resources Ltd
RMX	Red Mountain Mining Limited
RMXO	Red Mountain Mining Limited
RMXOK	RMXOK
RMY	Rma Global Limited
RND	Rand Mining NL
RNE	Renu Energy Limited
RNT	Rent.com.au Limited
RNTO	RNTO
RNU	Renaissance Uranium Limited
RNX	Renegade Exploration Limited
ROBO	Etfs Robo Global Robotics & Automation
ROC	Roc Oil Company Ltd
ROG	Red Sky Energy Ltd
RON	Ronin Resources Ltd
ROO	Roots Sustainable Agricultural Technologies Ltd
ROYL	ROYL
RPG	Raptis Group Ltd
RPL	Regal Partners Limited
RPM	Roma Petroleum NL
RPMO	Rpm Automotive Group Limited
RR1	Reach Resources Limited
RR1OA	RR1OA
RRL	Regis Resources NL
RRLKOC	Regis Resources Limited
RRLKOD	Regis Resources Limited
RRLKOE	Regis Resources Limited
RRLKOP	Regis Resources Limited
RRLKOR	Regis Resources Limited
RRR	Revolver Resources Holdings Ltd
RSG	Resolute Mining Ltd
RSH	Respiri Limited
RSHO	RSHO
RSM	Russell Australian Semi-government Bond
RTG	Rtg Mining Inc.
RTH	Ras Technology Holdings Limited
RTR	Rumble Resources Limited
RUL	Runge Ltd
RVS	Revasum Inc.
RVT	Richmond Vanadium Technology Limited
RWC	Reliance Worldwide Corporation Limited
RWCKOB	Reliance Worldwide Corporation Limited
RWCKOP	RWCKOP
RWCKOQ	Reliance Worldwide Corporation Limited
RWCKOR	RWCKOR
RWD	Reward Minerals Ltd
RWDO	Reward Minerals Ltd
RWL	Rubicon Water Limited
RXH	Rewardle Holdings Limited
RXL	Rox Resources Ltd
RXM	Rex Minerals Ltd
RYD	Ryder Capital Limited
RZI	Raiz Invest Limited
S2R	S2 Resources Ltd
S32	South32 Limited
S32KOA	South32 Limited
S32KOB	South32 Limited
S32KOC	South32 Limited
S32KOD	South32 Limited
S32KOE	South32 Limited
S32KOF	South32 Limited
S32KOG	South32 Limited
S32KOP	South32 Limited
S32KOQ	South32 Limited
S32KOR	South32 Limited
S32KOT	South32 Limited
S32KOV	South32 Limited
S3GO	S3GO
S66	Star Combo Pharma Limited
SAN	Sagalio Energy Limited
SB2	Salter Brothers Emerging Companies Limited
SBM	St Barbara Mines Ltd
SBR	Sabre Resources Ltd
SBW	Shekel Brainweigh Ltd
SCG	Scentre Group
SCGKOA	Scentre Group
SCGKOE	SCGKOE
SCGKOP	Scentre Group
SCGKOQ	Scentre Group
SCL	Schrole Group Ltd
SCN	Scorpion Minerals Limited
SCNO	SCNO
SCT	Scout Security Limited
SDF	Steadfast Group Limited
SDI	SDI Ltd
SDR	Sundowner Group
SDV	Scidev Ltd
SEC	Spheria Emerging Companies Limited
SEG	Segue Resources Ltd
SEK	Seek Ltd
SEKKOB	Seek Limited
SEKKOC	Seek Limited
SEKKOD	Seek Limited
SEKKOP	Seek Limited
SEKKOQ	Seek Limited
SEKKOR	Seek Limited
SEN	Senetas Corporation Ltd
SEQ	Southern Equity Holdings
SER	Strategic Energy Resources Ltd
SES	Solar Energy Systems
SFC	Schaffer Corporation Ltd
SFG	St Francis Group Ltd
SFM	Santa Fe Minerals Ltd
SFR	Sandfire Resources NL
SFRKOA	Sandfire Resources Nl
SFRKOB	Sandfire Resources Nl
SFRKOD	Sandfire Resources Nl
SFRKOE	Sandfire Resources Nl
SFRKOF	Sandfire Resources Nl
SFRKOG	Sandfire Resources Nl
SFRKOV	Sandfire Resources Nl
SFX	Sheffield Resources Limited
SFY	Spdr S&p/asx 50
SGA	Sarytogan Graphite Limited
SGAO	Sarytogan Graphite Limited
SGC	Sydney Gas Company Nl
SGF	Sg Fleet Group Limited
SGI	Signature Capital Investments Limited
SGLLV	Ricegrowers Limited
SGM	Sims Group Ltd
SGMKOA	Sims Metal Management Limited
SGMKOD	Sims Metal Management Limited
SGMKOF	Sims Metal Management Limited
SGMKOP	Sims Metal Management Limited
SGMKOQ	Sims Metal Management Limited
SGMKOS	Sims Metal Management Limited
SGMKOT	Sims Metal Management Limited
SGP	Stockland
SGPKOA	Stockland
SGPKOB	Stockland
SGPKOC	Stockland
SGPKOQ	Stockland
SGPKOR	Stockland
SGPKOS	Stockland
SGQ	St George Mining Limited
SGQO	St George Mining Limited
SGR	The Star Entertainment Group Limited
SGRKOC	The Star Entertainment Group Limited
SGRKOQ	The Star Entertainment Group Limited
SGRKOR	The Star Entertainment Group Limited
SHA	Shannon Resources Ltd
SHE	Stonehenge Metals Ltd
SHG	Sunshine Gas Ltd
SHJ	Shine Corporate Ltd
SHL	Sonic Healthcare Ltd
SHLKOB	Sonic Healthcare Limited
SHLKOP	Sonic Healthcare Limited
SHLKOQ	Sonic Healthcare Limited
SHM	Shriro Holdings Limited
SHN	Sherlock Bay Nickel Corporation Ltd
SHO	Sportshero Limited
SHP	Shoply Limited
SHV	Select Harvests Ltd
SI6	Six Sigma Metals Limited
SI6OF	SI6OF
SIG	Sigma Company Ltd
SIGKOB	Sigma Healthcare Limited
SIH	Sihayo Gold Limited
SIO	Simonds Group Limited
SIQ	Smartgroup Corporation Ltd
SIQKOB	Smartgroup Corporation Ltd
SIQKOC	Smartgroup Corporation Ltd
SIS	Simble Solutions Limited
SISO	SISO
SIT	SIT
SIV	Silver Chef Ltd
SIX	Sprintex Limited
SKC	Sky City Entertainment Group Ltd
SKN	Skansen Holdings
SKNOD	SKNOD
SKO	Serko Limited
SKS	Stokes (Australasia) Ltd
SKT	Sky Network Television Ltd
SKUK	SKUK
SKY	Skydome Holdings Ltd
SLB	Stelar Metals Limited
SLC	Softlaw Corporation Ltd
SLF	Spdr??s&p?/asx 200 Listed Property Fund
SLH	Silk Logistics Holdings Limited
SLM	Salmat Ltd
SLS	Solstice Minerals Limited
SLSO	SLSO
SLX	Silex Systems Ltd
SLZ	Sultan Resources Ltd
SLZO	SLZO
SM1	Synlait Milk Limited
SMI	Santana Minerals Limited
SMLL	Betashares Australian Small Companies Select
SMM	Summit Resources Ltd
SMMO	SMMO
SMN	Structural Monitoring Systems Plc
SMP	Smartpay Holdings Limited
SMR	Stanmore Coal Limited
SMS	Sims Group Ltd
SMSO	SMSO
SNC	Sandon Capital Investments Limited
SNCHA	SNCHA
SND	Saunders International Ltd
SNG	Siren Gold Limited
SNL	Supply Network Ltd
SNS	Sensen Networks Limited
SNT	Sky Network Television Ltd
SNX	Securenet
SNZ	Summerset Group Holdings Limited
SOC	Sovereign Gold Company Limited
SOL	Washington H Soul Pattison & Co Ltd
SOLKOA	Washington H Soul Pattinson & Company Limited
SOLKOB	Washington H Soul Pattinson & Company Limited
SOM	SomnoMed Ltd
SOP	Sml Corporation Limited
SOR	Strategic Elements Limited
SOV	Sovereign Cloud Holdings Limited
SP3	Spectur Limited
SP8	Streamplay Studio Limited
SPA	Spencer Resources Limited
SPD	Strategic Pooled Development Ltd
SPFKOA	S&p 500 Emini Futures
SPFKOD	S&p 500 Emini Futures
SPFKOE	S&p 500 Emini Futures
SPFKOG	S&p 500 Emini Futures
SPFKOH	S&p 500 Emini Futures
SPFKOL	SPFKOL
SPFKOM	SPFKOM
SPFMOB	SPFMOB
SPK	Spark New Zealand Limited
SPKKOA	SPKKOA
SPL	Starpharma Holdings Ltd
SPN	SP Ausnet
SPQ	Superior Resources Ltd
SPQOB	SPQOB
SPR	S8 Property Trust
SPX	Spinifex Gold Nl
SPXOA	SPXOA
SPY	Spdr??s&p 500? Etf Trust
SPZ	Smart Parking Limited
SQ2	Block Inc.
SQX	Sqx Resources Limited
SQXO	SQXO
SRG	Sydney Roads Group
SRH	Saferoads Holdings Ltd
SRI	Sipa Resources Ltd
SRJ	Srj Technologies Group Plc
SRK	Strike Resources Ltd
SRL	Straits Resources Ltd
SRN	Surefire Resources Nl
SRNOD	SRNOD
SRR	Shaw River Resources Ltd
SRT	Startrack Communications
SRV	Servcorp Ltd
SRX	Sirtex Medical Ltd
SRY	Story-i Limited
SRZ	Stellar Resources Ltd
SS1	Sun Silver Limited
SSG	Shaver Shop Group Limited
SSH	SSH Medical Ltd
SSL	Sietel Ltd
SSLPA	Sietel PA
SSM	Service Stream Ltd
SSO	Spdr??s&p?/asx Small Ordinaries
SSR	SSR Mining Inc
SST	Steamships Trading Company Ltd (PNG)
ST1	Spirit Telecom Limited
STA	Strandline Resources Limited
STG	Staging Connections Group Ltd
STK	Strickland Resources Limited
STM	Sunstone Metals Ltd
STN	Southern Titanium Nl
STO	Santos Ltd
STOKOA	Santos Limited
STOKOB	Santos Limited
STOKOC	Santos Limited
STOKOE	Santos Limited
STOKOF	Santos Limited
STOKOG	Santos Limited
STOKOH	Santos Limited
STOKOI	Santos Limited
STOKOJ	Santos Limited
STOKOK	Santos Limited
STOKOL	Santos Limited
STOKOM	Santos Limited
STOKON	Santos Limited
STOKOP	Santos Limited
STOKOQ	Santos Limited
STOKOR	Santos Limited
STOKOS	Santos Limited
STOKOU	Santos Limited
STP	Stericorp Ltd
STW	Spdr?s&p/asx 200
STX	Strike Oil Ltd
SUH	Southern Hemisphere Mining Limited
SUL	Super Cheap Auto Group Ltd
SULKOC	Super Retail Group Limited
SULKOD	Super Retail Group Limited
SULKOR	Super Retail Group Limited
SUM	Sumatra Copper & Gold Plc
SUMO	SUMO
SUN	Suncorp-Metway Ltd
SUNKOA	Suncorp Group Limited
SUNKOB	Suncorp Group Limited
SUNKOD	Suncorp Group Limited
SUNKOP	Suncorp Group Limited
SUNKOQ	Suncorp Group Limited
SUNKOS	Suncorp Group Limited
SUNPH	Suncorp Group Limited
SUNPI	SUNPI
SUNPJ	SUNPJ
SUV	Suvo Strategic Minerals Limited
SVG	Savannah Goldfields Limited
SVGO	SVGO
SVL	Silver Mines Ltd
SVM	Sovereign Metals Ltd
SVR	Solvar Limited
SVW	Seven Group Holdings Limited
SVWKOA	SVWKOA
SVWKOC	Seven Group Holdings Limited
SVWKOQ	SVWKOQ
SVWKOR	SVWKOR
SVY	Stavely Minerals Limited
SVYO	Stavely Minerals Limited
SW1	Swift Networks Group Limited
SWF	Selfwealth Limited
SWM	Seven West Media Limited
SWMKOR	Seven West Media Limited
SWP	Swoop Holdings Limited
SWTZ	SWTZ
SXE	Southern Cross Electrical Engineering Ltd
SXG	Southern Cross Goldfields Ltd
SXL	Southern Cross Media Group
SYA	Sayona Mining Limited
SYI	Spdr Msci Australia Select High Dividend Yield Fun
SYR	Syrah Resources Ltd
T3D	333d Limited
T3MP	T3MP
T88	Taiton Resources Limited
T92	Terra Uranium Limited
T92O	T92O
TAH	Tabcorp Holdings Ltd
TAHKOA	Tabcorp Holdings Limited
TAHKOC	Tabcorp Holdings Limited
TAHKOQ	Tabcorp Holdings Limited
TAHKOT	Tabcorp Holdings Limited
TAL	Tower Australia Group Ltd
TAM	Tanami Gold NL
TANN	TANN
TAR	Taruga Gold Limited
TAS	Tasman Resources NL
TAT	Tat Hong Holdings Ltd (Singapr CUFS)
TBA	Tombola Gold Ltd
TBIL	TBIL
TBN	Tamboran Resources Limited
TBR	Tribune Resources NL
TCF	360 Capital Enhanced Income Fund
TCG	Turaco Gold Limited
TCL	Transurban Group
TCLKOA	Transurban Group
TCLKOC	Transurban Group
TCLKOP	Transurban Group
TCLKOQ	Transurban Group
TCO	Transmetro Corporation Ltd
TD1	Tali Digital Limited
TDO	3D Oil Ltd
TEA	Terra Gold Mining Ltd
TECH	Etfs Global Core Infrastructure
TEE	Tele-IP Ltd
TEG	Triangle Energy (global) Limited
TEGO	Triangle Energy (global) Limited
TEK	Thorney Technologies Ltd
TEM	Tempo Services Ltd
TER	Terrain Australia Ltd
TFL	Tasfoods Limited
TG1	Techgen Metals Ltd
TG1O	TG1O
TG6	Tg Metals Limited
TGF	Tianshan Goldfields Ltd
TGH	Tegel Group Holdings Limited
TGM	Theta Gold Mines Limited
TGN	Tungsten Mining Nl
TGP	Trafalgar Corporate Group
THB	Thunderbird Resources Limited
THL	Tourism Holdings Rentals Limited
THR	Thor Mining Plc
THROD	THROD
TI1	Tombador Iron Limited
TIA	Tian An Australia Limited
TIG	Tigers Realm Coal Limited
TIP	Teaminvest Private Group Limited
TKL	Traka Resources Ltd
TKM	Trek Metals Limited
TKMO	TKMO
TLC	Tourism Hotels & Leisure Ltd
TLG	Talga Gold Limited
TLM	Talisman Mining Ltd
TLS	Telstra Corporation Ltd
TLSKOD	Telstra Corporation Limited.
TLSKOF	Telstra Corporation Limited.
TLSKOG	Telstra Corporation Limited.
TLSKOH	Telstra Corporation Limited.
TLSKOJ	Telstra Corporation Limited.
TLSKOM	Telstra Corporation Limited.
TLSKOP	Telstra Corporation Limited.
TLSKOQ	Telstra Corporation Limited.
TLSKOS	Telstra Corporation Limited.
TLSKOT	Telstra Corporation Limited.
TLSKOU	Telstra Corporation Limited.
TLSKOV	Telstra Corporation Limited.
TLX	Telix Pharmaceuticals Limited
TLXKOA	TLXKOA
TLXKOB	TLXKOB
TM1	Terra Metals Limited
TM1O	TM1O
TMB	Tambourah Metals Ltd
TMG	Trigg Mining Ltd.
TMGO	Trigg Mining Ltd.
TMGOD	TMGOD
TMK	Tamaska Oil And Gas Ltd
TMKO	Tamaska Oil And Gas Ltd
TMKOB	TMKOB
TML	Timah Resources Limited
TMS	Television & Media Services Ltd
TMSOA	TMSOA
TMX	Terrain Minerals Ltd
TMZ	Thomson Resources Limited
TMZOA	TMZOA
TNC	Transol Corporation Ltd
TNE	Technology One Ltd
TNEKOB	Technology One Limited
TNEKOD	Technology One Limited
TNY	Tennyson Networks Holdings
TOE	Toro Energy Ltd
TOEO	TOEO
TOK	Tolu Minerals Limited.
TON	Triton Gold Limited
TONOG	Triton Minerals Ltd
TOP	Thorney Opportunities Ltd
TOR	Ticor Ltd
TOT	360 Capital Total Return Fund
TOU	Tlou Energy Limited
TOY	Toysrus Anz Limited
TPC	Tel Pacific Ltd
TPG	Taragon Property Fund
TPGKOE	TPGKOE
TPW	Temple & Webster Group Ltd
TRA	Turners Automotive Group Limited
TRE	Toubani Resources Inc.
TRI	Triumph Tin Limited
TRJ	Trajan Minerals Ltd
TRM	Truscott Mining Corporation Ltd
TRP	Tissue Repair Ltd
TRS	Reject Shop Ltd (The)
TRU	Trust Company of Australia Ltd
TSI	Transfield Services Infrasture Fund
TSIO	TSIO
TSK	Task Group Holdings Limited
TSL	Titanium Sands Limited
TSLOA	TSLOA
TSO	Tishman Speyer Office Fund
TSOO	Tesoro Gold Ltd
TSOOA	TSOOA
TTA	TTA Holdings Ltd
TTI	Traffic Technologies Ltd
TTM	Titan Minerals Limited
TTT	Tritton Resources Ltd
TUA	Tuas Limited
TVL	Travel.com.au Ltd
TVN	TVSN Ltd
TVNO	TVNO
TWD	Tamawood Ltd
TWE	Treasury Wine Estates Limited
TWEKOA	Treasury Wine Estates Limited
TWEKOC	Treasury Wine Estates Limited
TWEKOP	Treasury Wine Estates Limited
TWEKOQ	Treasury Wine Estates Limited
TWR	Tower Ltd
TX3	Trinex Minerals Limited
TYP	Tryptamine Therapeutics Limited
TYR	Tyro Payments Limited
TYRKOC	TYRKOC
TYX	Tyranna Resources Limited
TZL	TZ Ltd
TZN	Terramin Australia Ltd
UBI	Universal Biosensors Ltd
UBIO	UBIO
UBN	Urbanise.com Limited
UCM	USCOM Ltd
UNI	Unilife Medical Solutions Ltd
UNT	Unith Ltd
UNTO	UNTO
UNTOA	UNTOA
UOS	United Overseas Australia Ltd
URF	Us Masters Residential Property Fund
URNM	URNM
URW	Unibail-rodamco-westfield
US10	US10
USD	Betashares U.s. Dollar
USIG	USIG
USL	Unico Silver Limited
USTB	USTB
UTIP	UTIP
UVA	Uvre Limited
VACF	Vanguard Australian Corporate Fixed Interest Index
VAE	Vanguard Ftse Asia Ex Japan Shares Index?
VAF	Vanguard Australian Fixed Interest Index
VAP	Vanguard Australian Property Securities Index Fund
VAR	Variscan Mines Limited
VAS	Vanguard Australian Shares Index
VBC	Verbrec Limited
VBS	Vectus Biosystems Limited
VBTC	VBTC
VCF	Vanguard?international Credit Securities Index (he
VCX	Vicinity Centres
VCXKOA	Vicinity Centres
VCXKOC	Vicinity Centres
VDBA	Vanguard Diversified Balanced Index
VDCO	Vanguard Diversified Conservative
VDGR	Vanguard Diversified Growth
VDHG	Vanguard Diversified High Growth
VEA	Veda Advantage Ltd
VEAKOA	VEAKOA
VEE	Veem Ltd
VEN	Vintage Energy Ltd
VEQ	Vanguard Ftse Europe Shares
VESG	Vanguard Ethically Conscious International Shares
VETH	VETH
VEU	Vanguard All-world Ex-us Shares Index Etf
VFX	Visionflex Group Limited
VG1	Vgi Partners Global Investments Limited
VGB	Vanguard Australian Government Bond Index
VGE	Vanguard Ftse Emerging Markets Shares
VGL	Volante Group Ltd
VGS	Vanguard Msci Index International Shares
VHM	Vhm Limited
VHY	Vanguard Australian Shares High Yield
VIF	Vanguard International Fixed Interest Index (hedge
VIG	Victor Group Holdings Limited
VIP	Voltage IP Ltd
VISM	Vanguard Msci International Small Companies Index
VIT	Vital Capital
VKA	Viking Ashanti Limited
VLC	Vanguard Msci Australian Large Companies Index
VLS	Vita Life Sciences
VMC	Venus Metals Corporation Limited
VMG	VDM Group Ltd
VMIN	Vanguard Global Minimum Volatility Active
VML	Vital Metals Ltd
VMM	Viridis Mining And Minerals Limited
VMS	Venture Minerals Ltd
VMSO	VMSO
VMT	Vmoto Ltd
VN8	Vonex Limited..
VNL	Vinyl Group Ltd
VNT	Ventia Services Group Limited
VPR	Volt Power Group Limited
VR1	Vection Technologies Ltd
VR8	Vanadium Resources Limited
VRC	Volt Resources Limited
VRCOB	Volt Resources Limited
VRS	Veris Limited
VRX	Ventnor Resources Ltd
VSL	Vision Systems Ltd
VSO	Vanguard Msci Australian Small Companies Index
VSR	Voltaic Strategic Resources Ltd
VSRO	VSRO
VTI	Virotec International Ltd
VTM	Volta Mining Limited
VTS	Vanguard U.s. Total Market Shares Index
VTX	Vortex Pipes Ltd
VTXO	Vtx Holdings Limited
VTXOA	VTXOA
VUK	Virgin Money Uk Plc
VUKKOA	VUKKOA
VUKKOB	VUKKOB
VUKKOE	VUKKOE
VUKKOF	VUKKOF
VUKKOP	Virgin Money Uk Plc
VUKKOQ	VUKKOQ
VUKKOR	Virgin Money Uk Plc
VUKKOU	VUKKOU
VUL	Valhalla Uranium Ltd
VVA	Viva Leisure Limited
VVLU	Vanguard Global Value Equity Active
VYS	Vysarn Limited
W2V	Way 2 Vat Ltd.
W2VO	W2VO
WA1	Wa1 Resources Ltd
WA8	Warriedar Resources Limited
WAA	Wam Active Ltd
WAF	West African Resources Limited
WAG	WorldAudio Ltd
WAK	Wa Kaolin Limited
WAM	WAM Capital Ltd
WAR	Wam Strategic Value Limited
WAT	Waterco Ltd
WAX	WAX
WBC	Westpac Banking Corporation
WBCKOA	Westpac Banking Corporation
WBCKOB	Westpac Banking Corporation
WBCKOC	Westpac Banking Corporation
WBCKOD	Westpac Banking Corporation
WBCKOE	Westpac Banking Corporation
WBCKOF	Westpac Banking Corporation
WBCKOG	Westpac Banking Corporation
WBCKOH	Westpac Banking Corporation
WBCKOO	Westpac Banking Corporation
WBCKOQ	Westpac Banking Corporation
WBCKOS	Westpac Banking Corporation
WBCKOT	Westpac Banking Corporation
WBCKOU	Westpac Banking Corporation
WBCKOV	Westpac Banking Corporation
WBCKOY	Westpac Banking Corporation
WBCKOZ	Westpac Banking Corporation
WBCMOB	Westpac Banking Corporation
WBCPH	Westpac Banking Corporation
WBCPI	Westpac Banking Corporation
WBCPJ	WBCPJ
WBCPK	WBCPK
WBCPL	Westpac Banking Corporation
WBCPM	WBCPM
WBE	Whitebark Energy Ltd
WBT	Weebit Nano Ltd
WC1	West Cobar Metals Limited
WC8	Wildcat Resources Limited
WCMQ	WCMQ
WCN	White Cliff Nickel Ltd
WCNO	White Cliff Nickel Ltd
WDMF	Ishares Edge Msci World Multifactor
WDS	Woodside Energy Group Ltd
WDSKOA	Woodside Energy Group Ltd
WDSKOB	Woodside Energy Group Ltd
WDSKOE	WDSKOE
WDSKOF	Woodside Energy Group Ltd
WDSKOL	Woodside Energy Group Ltd
WDSKOP	Woodside Energy Group Ltd
WDSKOQ	Woodside Energy Group Ltd
WDSKOR	Woodside Energy Group Ltd
WDSKOS	Woodside Energy Group Ltd
WDSKOU	Woodside Energy Group Ltd
WDSKOW	WDSKOW
WDSKOY	Woodside Energy Group Ltd
WDSMOA	Woodside Energy Group Ltd
WEB	Webjet Ltd
WEBKOA	Webjet Limited
WEBKOC	Webjet Limited
WEBKOD	Webjet Limited
WEBKOQ	Webjet Limited
WEBKOR	Webjet Limited
WEC	White Energy Company Ltd
WEL	Winchester Energy Ltd
WEMG	Spdr??s&p??emerging Markets Fund
WES	Wesfarmers Ltd
WESKOA	Wesfarmers Limited
WESKOB	Wesfarmers Limited
WESKOE	Wesfarmers Limited
WESKOF	Wesfarmers Limited
WESKOH	Wesfarmers Limited
WESKOI	Wesfarmers Limited
WESKOQ	Wesfarmers Limited
WESKOR	Wesfarmers Limited
WESKOV	Wesfarmers Limited
WESKOW	Wesfarmers Limited
WFL	Willmott Forests Ltd
WFLOB	WFLOB
WGB	Wam Global Limited
WGN	Wagners Holding Company Limited
WGR	Westgold Resources NL
WGX	Westgold Resources Limited.
WHC	Whitehaven Coal Ltd
WHCKOA	Whitehaven Coal Limited
WHCKOC	Whitehaven Coal Limited
WHCKOG	Whitehaven Coal Limited
WHCKOJ	Whitehaven Coal Limited
WHCKOK	Whitehaven Coal Limited
WHCKOP	Whitehaven Coal Limited
WHCKOQ	Whitehaven Coal Limited
WHCKOR	Whitehaven Coal Limited
WHCKOX	Whitehaven Coal Limited
WHCKOZ	Whitehaven Coal Limited
WHF	Whitefield Ltd
WHFPA	Whitefield PA
WHFPB	Whitefield Limited
WHK	Whitehawk Limited
WHKO	WHKO
WIA	Wia Gold Limited
WIN	Windward Resources Ltd
WKT	Walkabout Resources Ltd
WLD	Wellard Limited
WLE	Wam Leaders
WMA	Wam Alternative Assets Limited
WMG	Westmag Ltd
WMI	Wam Microcap Limited
WML	Westcoast Mining Ltd
WNR	Wingara Ag Ltd
WNX	Wellnex Life Limited
WOA	Wide Open Agriculture Ltd
WOAO	Wide Open Agriculture Ltd
WOR	WorleyParsons Ltd
WORKOB	Worleyparsons Limited
WORKOC	Worleyparsons Limited
WORKOF	Worleyparsons Limited
WORKOR	Worleyparsons Limited
WORKOS	Worleyparsons Limited
WORKOV	Worleyparsons Limited
WOT	Westpac Office Trust
WOW	Woolworths Ltd
WOWKOA	Woolworths Limited
WOWKOC	Woolworths Limited
WOWKOE	Woolworths Limited
WOWKOQ	Woolworths Limited
WOWKOR	Woolworths Limited
WOWKOT	Woolworths Limited
WOWKOX	Woolworths Limited
WPR	Waypoint Reit
WQG	Wcm Global Growth Limited
WR1	Winsome Resources Limited
WRK	Warwick Resources Ltd
WSI	Weststar Industrial Limited
WSR	Whitestar Resources Limited
WSROA	WSROA
WTC	Wisetech Global Limited
WTCKOA	Wisetech Global Limited
WTCKOB	Wisetech Global Limited
WTCKOE	Wisetech Global Limited
WTCKOF	Wisetech Global Limited
WTL	Wt Financial Group Limited
WTM	Waratah Minerals Limited
WTN	Western Uranium Ltd
WVOL	Ishares Edge Msci World Minimum Volatility
WWG	WWG
WWI	West Wits Mining Ltd
WXHG	Spdr??s&p??world Ex-australia (hedged) Fund
WXOZ	Spdr??s&p??world Ex-australia Fund
WYX	Western Yilgarn Nl
WYXO	WYXO
WZR	Wisr Limited
X2M	X2m Connect Limited
X2MO	X2m Connect Limited
X64	Ten Sixty Four Limited
XAE	
XAF	S&P/ASX All Australian 50
XALG	XALG
XAM	Xanadu Mines Limited
XAO	ASX All Ordinaries
XARO	XARO
XASG	XASG
XAT	S&P/ASX All Australian 200
XBK	
XBN	
XBT	
XBW	S&P/ASX Buy-Write Index
XCO2	XCO2
XDI	
XDJ	S&P/ASX 200 Consumer Discretionary
XEC	
XEJ	S&P/ASX 200 Energy
XET	
XEW	
XF1	Xref Limited
XFJ	S&P/ASX 200 Financials
XFL	S&P/ASX 50
XGD	S&P/ASX All Ordinaries Gold
XGL	Xamble Group Limited
XHJ	S&P/ASX 200 Health Care
XIJ	S&P/ASX 200 Information Technology
XIN	
XJO	S&P/ASX 200
XJOBOB	XJOBOB
XJOBOC	XJOBOC
XJOKOB	XJOKOB
XJOKOD	XJOKOD
XJOKOJ	XJOKOJ
XJOKOL	XJOKOL
XJOKOM	XJOKOM
XJOKON	XJOKON
XJOKOO	XJOKOO
XJOKOW	XJOKOW
XJOKOZ	XJOKOZ
XJOLOH	XJOLOH
XJOMOP	XJOMOP
XJOMOQ	XJOMOQ
XJOMOR	XJOMOR
XJOMOS	XJOMOS
XJOMOT	XJOMOT
XJOMOV	XJOMOV
XJOQOB	XJOQOB
XJOQOD	XJOQOD
XJOQOF	XJOQOF
XJOQOG	XJOQOG
XJOTOI	XJOTOI
XJOTOK	XJOTOK
XJOTOL	XJOTOL
XJOTOM	XJOTOM
XJOTON	XJOTON
XJOTOO	XJOTOO
XJOUOB	XJOUOB
XJOUOF	XJOUOF
XJOUOL	XJOUOL
XJOUOO	XJOUOO
XJR	
XJT	
XKO	S&P/ASX 300
XLD	
XMD	S&P/ASX Midcap 50
XMET	XMET
XMJ	S&P/ASX 200 Materials
XMM	S&P/ASX 300 Metals And Mining
XNJ	S&P/ASX 200 Industrials
XNT	
XNV	
XPJ	S&P/ASX 200 Property Trusts
XPN	Xpon Technologies Group Limited
XRE	S&P/ASX 200 Real Estate
XRF	XRF Scientific Ltd
XRG	Xreality Group Ltd
XRO	Xero Limited
XROKOC	Xero Limited
XROKOD	Xero Limited
XROKOR	XROKOR
XSJ	S&P/ASX 200 Consumer Staples
XSO	S&P/ASX Small Ordinaries
XST	Xstate Resources Ltd
XSY	
XTJ	S&P/ASX 200 Telecommunication Services
XTL	S&P/ASX 20
XTO	S&P/ASX 100
XUJ	S&P/ASX 200 Utilities
XVI	
XXJ	S&P/ASX 200 Financials x Property Trusts
YAL	Yancoal Australia Limited
YANK	Betashares Strong U.s. Dollar
YAR	Yari Minerals Limited
YAROD	YAROD
YOJ	Yojee Limited
YOW	Yowie Group Ltd
YPB	Ypb Group Ltd
YRL	Yandal Resources Limited
Z2U	Zoom2u Technologies Limited
ZAG	Zuleika Gold Limited
ZCLKOA	ZCLKOA
ZCLKOD	ZCLKOD
ZCLKOE	ZCLKOE
ZCLKOF	ZCLKOF
ZCLKOJ	ZCLKOJ
ZCLKOQ	ZCLKOQ
ZCLKOR	ZCLKOR
ZCLKOY	ZCLKOY
ZEO	Zeotech Limited
ZER	Zeta Resources Limited
ZEU	Zeus Resources Limited
ZEUO	ZEUO
ZGCKOA	ZGCKOA
ZGCKOB	ZGCKOB
ZGCKOD	ZGCKOD
ZGCKOE	ZGCKOE
ZGCKOF	ZGCKOF
ZGCKOH	ZGCKOH
ZGCKOI	ZGCKOI
ZGCKOJ	ZGCKOJ
ZGCKOK	ZGCKOK
ZGCKOL	ZGCKOL
ZGCKOP	ZGCKOP
ZGCKOR	ZGCKOR
ZGCKOV	ZGCKOV
ZGCKOW	ZGCKOW
ZGCKOY	ZGCKOY
ZGCMOP	ZGCMOP
ZGL	Zicom Group Ltd
ZHGKOA	ZHGKOA
ZHGKOB	ZHGKOB
ZHGKOD	ZHGKOD
ZHGKOF	ZHGKOF
ZHGKOP	ZHGKOP
ZHGKOQ	ZHGKOQ
ZHGKOR	ZHGKOR
ZHGKOS	ZHGKOS
ZHGKOT	ZHGKOT
ZHGKOX	ZHGKOX
ZIM	Zimbabwe Platinum Mines Ltd
ZIP	Ziptel Limited
ZIPKOA	Zip Co Limited..
ZIPKOB	ZIPKOB
ZIPKOC	Zip Co Limited..
ZLD	Zelda Therapeutics Limited
ZMI	Zinc Of Ireland Nl
ZMM	Zimi Limited
ZNC	Zinc Co Australia Ltd
ZNO	Zoono Group Limited
ZSIKOA	ZSIKOA
ZSIKOC	ZSIKOC
ZSIKOE	ZSIKOE
ZSIKOI	ZSIKOI
ZSIKOJ	ZSIKOJ
ZSIKOK	ZSIKOK
ZSIKOL	ZSIKOL
ZSIKOP	ZSIKOP
ZSIKOR	ZSIKOR
ZSIKOT	ZSIKOT
ZSIKOU	ZSIKOU
ZSIKOZ	ZSIKOZ
ZSIMOP	ZSIMOP
ZYAU	Anz Etfs S&p/asx 300 High Yield Plus
